"Region","Type","Category","Month","month_12","month_4","month_3","month_2","new_inactive","new_active","old_active","old","new","old_inactive","active","inactive","total","sv_10","sv_20","sv_30","svo_10","svo_20","svo_30"
"Region1","retail","Retail Store","January",11,3,3,4,2,14,305,326,16,21,319,23,342,2,5,2,4,4,3
"Region1","retail","Retail Store","February",10,4,3,3,3,10,378,398,13,20,388,23,411,3,3,3,4,3,3
"Region1","retail","Retail Store","March",12,3,2,4,4,14,430,451,18,21,444,25,469,4,4,2,4,5,3
"Region1","retail","Retail Store","April",10,4,3,4,3,14,325,346,17,21,339,24,363,3,5,3,5,4,2
"Region1","retail","Retail Store","May",12,3,3,3,3,14,357,378,17,21,371,24,395,5,3,4,3,3,2
"Region1","retail","Retail Store","June",12,2,3,3,3,14,404,424,17,20,418,23,441,3,3,4,5,3,3
"Region1","retail","Retail Store","July",11,5,3,4,5,11,390,413,16,23,401,28,429,5,4,2,3,2,4
"Region1","retail","Retail Store","August",12,3,5,3,2,11,478,501,13,23,489,25,514,4,2,4,3,2,4
"Region1","retail","Retail Store","September",13,2,3,2,3,10,457,477,13,20,467,23,490,3,3,2,3,2,5
"Region1","retail","Retail Store","October",12,3,3,3,4,10,472,493,14,21,482,25,507,4,2,3,4,3,3
"Region1","retail","Retail Store","November",12,3,4,3,5,15,498,520,20,22,513,27,540,4,2,4,4,4,5
"Region1","retail","Kirana Store","January",10,3,3,4,2,14,316,336,16,20,330,22,352,2,5,4,4,2,4
"Region1","retail","Kirana Store","February",12,4,3,5,4,13,475,499,17,24,488,28,516,2,2,4,5,3,5
"Region1","retail","Kirana Store","March",10,4,3,5,3,14,407,429,17,22,421,25,446,4,2,2,5,2,4
"Region1","retail","Kirana Store","April",11,5,3,3,3,13,470,492,16,22,483,25,508,4,2,3,3,5,2
"Region1","retail","Kirana Store","May",10,2,4,4,2,13,493,513,15,20,506,22,528,3,2,5,4,2,3
"Region1","retail","Kirana Store","June",11,4,3,3,4,15,453,474,19,21,468,25,493,5,2,2,3,2,5
"Region1","retail","Kirana Store","July",12,3,4,5,3,15,404,428,18,24,419,27,446,3,4,2,2,4,3
"Region1","retail","Kirana Store","August",10,4,5,4,3,15,482,505,18,23,497,26,523,3,3,3,2,2,3
"Region1","retail","Kirana Store","September",12,2,2,3,5,14,361,380,19,19,375,24,399,4,4,3,3,4,3
"Region1","retail","Kirana Store","October",12,4,2,5,2,11,317,340,13,23,328,25,353,4,3,4,2,3,3
"Region1","retail","Kirana Store","November",12,4,4,4,5,13,451,475,18,24,464,29,493,3,3,4,2,5,3
"Region1","retail","Hotels","January",10,3,3,5,2,13,497,518,15,21,510,23,533,4,2,2,4,4,3
"Region1","retail","Hotels","February",12,3,3,2,3,15,433,453,18,20,448,23,471,2,3,3,5,4,4
"Region1","retail","Hotels","March",12,2,5,3,2,13,363,385,15,22,376,24,400,4,5,2,5,4,3
"Region1","retail","Hotels","April",11,3,3,3,4,10,377,397,14,20,387,24,411,4,3,3,3,2,4
"Region1","retail","Hotels","May",12,4,4,4,2,15,447,471,17,24,462,26,488,4,5,3,4,5,4
"Region1","retail","Hotels","June",12,4,5,2,5,13,485,508,18,23,498,28,526,2,2,5,4,2,5
"Region1","retail","Hotels","July",11,5,3,3,4,12,412,434,16,22,424,26,450,2,5,5,4,4,3
"Region1","retail","Hotels","August",10,3,3,3,5,14,423,442,19,19,437,24,461,5,3,2,3,3,3
"Region1","retail","Hotels","September",12,3,4,3,4,12,437,459,16,22,449,26,475,4,2,3,2,4,4
"Region1","retail","Hotels","October",12,3,5,3,4,13,418,441,17,23,431,27,458,3,3,4,3,3,5
"Region1","retail","Hotels","November",10,3,3,4,4,13,391,411,17,20,404,24,428,3,4,2,4,2,5
"Region1","retail","Restaurants","January",10,3,4,3,2,13,480,500,15,20,493,22,515,2,5,4,4,2,4
"Region1","retail","Restaurants","February",12,4,3,4,4,13,474,497,17,23,487,27,514,5,3,5,3,4,3
"Region1","retail","Restaurants","March",12,5,3,4,4,15,318,342,19,24,333,28,361,3,5,4,4,3,4
"Region1","retail","Restaurants","April",11,5,2,4,4,13,485,507,17,22,498,26,524,2,4,2,4,3,4
"Region1","retail","Restaurants","May",10,3,4,2,4,13,374,393,17,19,387,23,410,3,4,3,3,4,4
"Region1","retail","Restaurants","June",12,4,5,4,5,15,380,405,20,25,395,30,425,4,5,4,5,3,5
"Region1","retail","Restaurants","July",12,4,4,3,3,10,370,393,13,23,380,26,406,4,2,3,3,4,3
"Region1","retail","Restaurants","August",12,3,2,4,3,14,380,401,17,21,394,24,418,4,4,4,4,4,2
"Region1","retail","Restaurants","September",12,3,2,3,2,12,334,354,14,20,346,22,368,4,3,4,4,5,5
"Region1","retail","Restaurants","October",11,4,3,3,3,14,414,435,17,21,428,24,452,2,4,4,5,2,5
"Region1","retail","Restaurants","November",13,3,3,4,5,14,480,503,19,23,494,28,522,4,3,4,5,4,2
"Region1","retail","Airline","January",12,2,3,5,3,15,382,404,18,22,397,25,422,2,4,2,4,3,3
"Region1","retail","Airline","February",11,2,2,2,3,11,313,330,14,17,324,20,344,2,2,4,4,5,4
"Region1","retail","Airline","March",13,2,3,4,4,11,331,353,15,22,342,26,368,4,4,4,4,4,3
"Region1","retail","Airline","April",12,4,3,2,5,12,304,325,17,21,316,26,342,3,3,3,4,3,5
"Region1","retail","Airline","May",12,4,3,4,5,14,443,466,19,23,457,28,485,5,4,4,4,5,3
"Region1","retail","Airline","June",13,4,4,3,5,15,383,407,20,24,398,29,427,3,5,5,5,4,5
"Region1","retail","Airline","July",13,4,5,2,2,10,336,360,12,24,346,26,372,3,4,3,5,4,4
"Region1","retail","Airline","August",10,4,4,4,3,10,472,494,13,22,482,25,507,4,3,2,5,2,5
"Region1","retail","Airline","September",11,4,3,4,2,12,459,481,14,22,471,24,495,3,5,4,4,2,3
"Region1","retail","Airline","October",13,4,4,2,5,13,359,382,18,23,372,28,400,4,2,4,2,3,5
"Region1","retail","Airline","November",11,4,2,5,2,15,386,408,17,22,401,24,425,3,3,3,2,4,3
"Region1","retail","Hardware Store","January",11,3,5,3,4,13,493,515,17,22,506,26,532,4,4,3,2,5,4
"Region1","retail","Hardware Store","February",13,2,3,5,4,11,390,413,15,23,401,27,428,3,5,3,3,3,3
"Region1","retail","Hardware Store","March",10,3,4,3,4,15,377,397,19,20,392,24,416,3,4,5,3,2,2
"Region1","retail","Hardware Store","April",11,5,5,3,4,13,305,329,17,24,318,28,346,4,2,2,2,5,2
"Region1","retail","Hardware Store","May",11,4,5,4,5,14,403,427,19,24,417,29,446,5,3,3,5,3,4
"Region1","retail","Hardware Store","June",12,4,4,3,2,11,470,493,13,23,481,25,506,3,3,4,3,4,5
"Region1","retail","Hardware Store","July",12,4,5,4,3,12,499,524,15,25,511,28,539,3,5,3,2,4,5
"Region1","retail","Hardware Store","August",12,4,5,3,3,12,363,387,15,24,375,27,402,3,5,4,2,5,3
"Region1","retail","Hardware Store","September",12,3,5,3,2,13,345,368,15,23,358,25,383,4,5,3,3,5,5
"Region1","retail","Hardware Store","October",10,2,2,4,5,10,465,483,15,18,475,23,498,3,4,5,4,3,2
"Region1","retail","Hardware Store","November",12,4,3,4,2,15,426,449,17,23,441,25,466,4,3,5,3,2,3
"Region1","retail","Computer Store","January",12,3,4,3,4,12,349,371,16,22,361,26,387,3,4,4,5,5,2
"Region1","retail","Computer Store","February",13,4,5,3,5,12,406,431,17,25,418,30,448,4,4,3,4,5,4
"Region1","retail","Computer Store","March",13,3,4,2,5,10,361,383,15,22,371,27,398,4,3,3,2,3,3
"Region1","retail","Computer Store","April",13,3,4,5,3,13,363,388,16,25,376,28,404,3,4,2,4,2,5
"Region1","retail","Computer Store","May",10,4,2,3,3,13,483,502,16,19,496,22,518,5,3,4,3,3,3
"Region1","retail","Computer Store","June",11,2,3,3,2,12,402,421,14,19,414,21,435,4,4,4,3,4,5
"Region1","retail","Computer Store","July",10,3,3,4,2,15,381,401,17,20,396,22,418,3,4,5,5,2,4
"Region1","retail","Computer Store","August",11,3,4,2,3,14,449,469,17,20,463,23,486,5,4,4,5,3,2
"Region1","retail","Computer Store","September",11,4,4,5,3,13,499,523,16,24,512,27,539,3,2,4,4,2,4
"Region1","retail","Computer Store","October",12,4,4,5,3,12,356,381,15,25,368,28,396,2,5,2,4,5,2
"Region1","retail","Computer Store","November",10,3,4,4,3,12,484,505,15,21,496,24,520,2,4,4,2,4,3
"Region1","retail","Gaming Zone","January",11,3,2,2,4,15,447,465,19,18,462,22,484,2,3,4,3,4,3
"Region1","retail","Gaming Zone","February",11,4,2,3,3,12,311,331,15,20,323,23,346,3,5,4,4,3,5
"Region1","retail","Gaming Zone","March",11,2,4,4,3,13,335,356,16,21,348,24,372,4,2,4,4,3,4
"Region1","retail","Gaming Zone","April",13,3,2,3,5,13,354,375,18,21,367,26,393,5,2,2,5,3,2
"Region1","retail","Gaming Zone","May",11,3,4,3,2,11,337,358,13,21,348,23,371,4,3,5,5,4,4
"Region1","retail","Gaming Zone","June",10,2,3,3,3,14,458,476,17,18,472,21,493,3,4,4,3,3,2
"Region1","retail","Gaming Zone","July",11,3,2,2,3,12,471,489,15,18,483,21,504,3,2,2,4,3,4
"Region1","retail","Gaming Zone","August",12,2,2,4,3,14,335,355,17,20,349,23,372,5,3,4,4,4,4
"Region1","retail","Gaming Zone","September",13,5,4,2,5,12,438,462,17,24,450,29,479,4,2,5,4,3,4
"Region1","retail","Gaming Zone","October",12,2,2,5,4,14,372,393,18,21,386,25,411,2,4,5,5,3,4
"Region1","retail","Gaming Zone","November",10,2,4,5,3,14,303,324,17,21,317,24,341,3,3,3,4,3,2
"Region1","retail","Super MArket","January",12,3,4,4,5,13,457,480,18,23,470,28,498,2,4,4,3,4,3
"Region1","retail","Super MArket","February",12,5,2,2,3,11,370,391,14,21,381,24,405,4,4,4,3,3,4
"Region1","retail","Super MArket","March",13,4,4,4,4,13,473,498,17,25,486,29,515,4,2,2,4,3,5
"Region1","retail","Super MArket","April",12,2,3,4,2,10,477,498,12,21,487,23,510,4,3,4,3,3,3
"Region1","retail","Super MArket","May",11,2,4,3,3,12,417,437,15,20,429,23,452,2,4,5,4,3,2
"Region1","retail","Super MArket","June",13,5,4,5,3,10,369,396,13,27,379,30,409,3,2,4,2,3,4
"Region1","retail","Super MArket","July",11,3,3,5,5,14,416,438,19,22,430,27,457,4,3,5,5,5,3
"Region1","retail","Super MArket","August",11,2,3,4,5,13,461,481,18,20,474,25,499,3,4,4,3,4,5
"Region1","retail","Super MArket","September",11,4,4,4,3,14,357,380,17,23,371,26,397,3,3,4,3,5,2
"Region1","retail","Super MArket","October",13,4,4,4,3,14,403,428,17,25,417,28,445,4,3,2,4,3,5
"Region1","retail","Super MArket","November",13,3,3,3,4,13,380,402,17,22,393,26,419,5,3,2,4,4,4
"Region1","retail","Fast Food Centre","January",13,4,4,3,3,14,337,361,17,24,351,27,378,3,2,3,5,3,4
"Region1","retail","Fast Food Centre","February",11,3,4,3,5,12,361,382,17,21,373,26,399,3,5,4,5,3,4
"Region1","retail","Fast Food Centre","March",12,3,5,4,4,13,470,494,17,24,483,28,511,3,3,2,4,5,4
"Region1","retail","Fast Food Centre","April",12,5,3,4,2,13,492,516,15,24,505,26,531,4,3,2,5,4,3
"Region1","retail","Fast Food Centre","May",11,3,4,4,4,12,310,332,16,22,322,26,348,3,5,2,4,2,5
"Region1","retail","Fast Food Centre","June",12,4,5,4,4,12,334,359,16,25,346,29,375,5,2,2,4,2,2
"Region1","retail","Fast Food Centre","July",13,4,2,3,3,14,474,496,17,22,488,25,513,4,3,3,2,4,4
"Region1","retail","Fast Food Centre","August",13,3,4,4,2,11,420,444,13,24,431,26,457,3,2,4,4,4,4
"Region1","retail","Fast Food Centre","September",10,3,5,2,4,12,331,351,16,20,343,24,367,3,3,3,3,4,5
"Region1","retail","Fast Food Centre","October",11,4,2,4,4,12,430,451,16,21,442,25,467,2,4,3,3,3,4
"Region1","retail","Fast Food Centre","November",10,5,3,4,5,11,345,367,16,22,356,27,383,4,5,4,4,4,4
"Region1","holding","Retail Store","January",10,2,4,4,3,11,408,428,14,20,419,23,442,3,4,2,2,4,4
"Region1","holding","Retail Store","February",11,3,5,4,3,10,363,386,13,23,373,26,399,2,3,2,4,3,3
"Region1","holding","Retail Store","March",10,2,4,2,4,12,341,359,16,18,353,22,375,3,3,3,5,2,4
"Region1","holding","Retail Store","April",11,2,4,5,4,12,324,346,16,22,336,26,362,2,4,2,2,4,4
"Region1","holding","Retail Store","May",13,4,5,2,3,14,465,489,17,24,479,27,506,2,3,5,5,2,3
"Region1","holding","Retail Store","June",12,4,4,3,4,14,337,360,18,23,351,27,378,4,4,5,3,3,5
"Region1","holding","Retail Store","July",10,2,4,2,2,12,430,448,14,18,442,20,462,3,3,3,3,2,2
"Region1","holding","Retail Store","August",13,5,3,3,4,12,401,425,16,24,413,28,441,4,4,3,3,4,3
"Region1","holding","Retail Store","September",11,3,2,3,5,11,372,391,16,19,383,24,407,5,5,3,4,5,3
"Region1","holding","Retail Store","October",11,3,2,3,3,15,332,351,18,19,347,22,369,4,4,3,3,2,3
"Region1","holding","Retail Store","November",11,5,4,3,3,10,497,520,13,23,507,26,533,4,5,4,3,2,2
"Region1","holding","Kirana Store","January",13,2,3,4,2,14,429,451,16,22,443,24,467,4,4,5,2,5,5
"Region1","holding","Kirana Store","February",13,3,3,5,4,13,377,401,17,24,390,28,418,5,3,4,4,4,5
"Region1","holding","Kirana Store","March",12,3,4,3,4,14,359,381,18,22,373,26,399,4,2,5,3,3,3
"Region1","holding","Kirana Store","April",13,2,2,3,4,12,431,451,16,20,443,24,467,3,2,3,3,4,3
"Region1","holding","Kirana Store","May",11,5,4,5,3,13,436,461,16,25,449,28,477,5,4,5,3,3,4
"Region1","holding","Kirana Store","June",11,3,5,4,4,11,431,454,15,23,442,27,469,4,4,4,4,4,3
"Region1","holding","Kirana Store","July",11,5,4,4,4,11,355,379,15,24,366,28,394,5,4,3,4,4,2
"Region1","holding","Kirana Store","August",13,2,2,3,5,14,326,346,19,20,340,25,365,4,3,4,5,5,3
"Region1","holding","Kirana Store","September",12,3,3,4,3,15,374,396,18,22,389,25,414,3,5,4,3,3,2
"Region1","holding","Kirana Store","October",11,4,4,4,5,12,473,496,17,23,485,28,513,2,5,5,5,3,4
"Region1","holding","Kirana Store","November",11,4,3,2,5,13,488,508,18,20,501,25,526,5,4,3,4,5,4
"Region1","holding","Hotels","January",12,2,4,4,5,15,330,352,20,22,345,27,372,2,3,3,4,5,5
"Region1","holding","Hotels","February",13,5,4,3,4,13,374,399,17,25,387,29,416,3,3,3,4,4,2
"Region1","holding","Hotels","March",11,5,3,3,4,15,425,447,19,22,440,26,466,3,4,4,4,3,2
"Region1","holding","Hotels","April",11,5,4,2,4,13,437,459,17,22,450,26,476,5,4,3,2,5,4
"Region1","holding","Hotels","May",13,5,4,2,2,11,493,517,13,24,504,26,530,3,2,3,2,3,3
"Region1","holding","Hotels","June",12,4,2,4,4,12,399,421,16,22,411,26,437,4,3,4,2,4,4
"Region1","holding","Hotels","July",12,4,3,4,5,14,425,448,19,23,439,28,467,4,3,3,5,3,3
"Region1","holding","Hotels","August",10,3,4,2,4,14,494,513,18,19,508,23,531,4,3,3,4,3,3
"Region1","holding","Hotels","September",13,5,5,3,5,10,345,371,15,26,355,31,386,2,5,4,3,4,4
"Region1","holding","Hotels","October",12,5,3,4,4,15,414,438,19,24,429,28,457,5,3,3,3,2,4
"Region1","holding","Hotels","November",12,4,2,3,4,11,352,373,15,21,363,25,388,3,4,2,5,3,5
"Region1","holding","Restaurants","January",11,4,4,4,4,11,475,498,15,23,486,27,513,3,5,2,4,3,3
"Region1","holding","Restaurants","February",10,4,3,4,4,12,425,446,16,21,437,25,462,3,3,5,3,3,2
"Region1","holding","Restaurants","March",12,3,3,2,4,15,403,423,19,20,418,24,442,5,3,4,4,4,3
"Region1","holding","Restaurants","April",13,3,5,4,4,15,376,401,19,25,391,29,420,4,3,5,3,4,5
"Region1","holding","Restaurants","May",11,5,3,5,3,13,451,475,16,24,464,27,491,3,5,4,3,3,2
"Region1","holding","Restaurants","June",13,4,4,4,2,13,368,393,15,25,381,27,408,5,2,2,5,4,2
"Region1","holding","Restaurants","July",12,3,3,5,2,12,432,455,14,23,444,25,469,4,2,4,4,3,3
"Region1","holding","Restaurants","August",11,3,3,2,3,11,313,332,14,19,324,22,346,4,3,4,2,3,3
"Region1","holding","Restaurants","September",10,4,5,3,3,12,320,342,15,22,332,25,357,3,3,3,4,3,4
"Region1","holding","Restaurants","October",10,3,4,3,4,13,305,325,17,20,318,24,342,5,4,4,4,2,4
"Region1","holding","Restaurants","November",12,3,2,5,2,10,352,374,12,22,362,24,386,3,4,5,2,4,2
"Region1","holding","Airline","January",12,4,4,5,2,14,497,522,16,25,511,27,538,4,4,2,3,4,3
"Region1","holding","Airline","February",10,3,2,4,3,12,462,481,15,19,474,22,496,4,4,3,3,3,3
"Region1","holding","Airline","March",10,4,4,4,2,14,479,501,16,22,493,24,517,4,4,3,3,2,2
"Region1","holding","Airline","April",12,2,4,2,4,13,413,433,17,20,426,24,450,4,4,3,2,3,3
"Region1","holding","Airline","May",11,3,4,4,5,14,398,420,19,22,412,27,439,3,3,5,3,4,3
"Region1","holding","Airline","June",12,4,4,2,2,11,378,400,13,22,389,24,413,3,2,3,2,4,3
"Region1","holding","Airline","July",12,3,2,3,4,10,343,363,14,20,353,24,377,5,3,4,3,4,3
"Region1","holding","Airline","August",12,4,3,3,5,11,435,457,16,22,446,27,473,2,2,3,2,4,3
"Region1","holding","Airline","September",13,4,3,3,2,11,306,329,13,23,317,25,342,5,5,4,4,3,3
"Region1","holding","Airline","October",11,5,3,4,2,11,323,346,13,23,334,25,359,3,3,4,4,4,5
"Region1","holding","Airline","November",13,4,5,2,3,10,399,423,13,24,409,27,436,4,5,4,3,5,3
"Region1","holding","Hardware Store","January",11,3,3,3,3,15,407,427,18,20,422,23,445,4,5,4,4,2,4
"Region1","holding","Hardware Store","February",11,5,4,3,4,10,331,354,14,23,341,27,368,3,5,5,5,3,5
"Region1","holding","Hardware Store","March",10,3,4,2,2,11,320,339,13,19,331,21,352,3,2,5,5,2,2
"Region1","holding","Hardware Store","April",12,4,2,5,4,10,367,390,14,23,377,27,404,4,3,3,5,3,3
"Region1","holding","Hardware Store","May",11,4,2,4,5,13,422,443,18,21,435,26,461,4,2,2,3,5,5
"Region1","holding","Hardware Store","June",10,3,3,4,4,10,355,375,14,20,365,24,389,2,3,3,2,4,4
"Region1","holding","Hardware Store","July",11,3,2,2,3,15,308,326,18,18,323,21,344,3,2,2,4,5,4
"Region1","holding","Hardware Store","August",11,3,4,3,3,11,422,443,14,21,433,24,457,4,4,4,2,4,2
"Region1","holding","Hardware Store","September",10,3,3,4,4,12,362,382,16,20,374,24,398,3,3,5,5,4,5
"Region1","holding","Hardware Store","October",13,4,4,2,4,14,471,494,18,23,485,27,512,3,3,3,5,3,5
"Region1","holding","Hardware Store","November",12,2,4,4,3,11,380,402,14,22,391,25,416,3,4,2,5,4,2
"Region1","holding","Computer Store","January",13,4,3,3,4,13,483,506,17,23,496,27,523,5,4,4,4,3,3
"Region1","holding","Computer Store","February",13,2,4,4,4,14,451,474,18,23,465,27,492,5,2,3,4,3,2
"Region1","holding","Computer Store","March",13,2,4,4,3,12,495,518,15,23,507,26,533,3,3,4,3,5,5
"Region1","holding","Computer Store","April",11,3,3,2,4,13,365,384,17,19,378,23,401,5,4,4,5,3,4
"Region1","holding","Computer Store","May",10,4,3,4,4,11,335,356,15,21,346,25,371,5,3,4,3,3,4
"Region1","holding","Computer Store","June",13,2,2,3,2,13,456,476,15,20,469,22,491,4,3,4,3,3,3
"Region1","holding","Computer Store","July",12,3,5,5,4,12,352,377,16,25,364,29,393,4,4,2,3,3,4
"Region1","holding","Computer Store","August",11,2,4,3,2,11,366,386,13,20,377,22,399,3,2,4,2,2,3
"Region1","holding","Computer Store","September",11,5,3,5,4,11,445,469,15,24,456,28,484,4,3,4,4,3,5
"Region1","holding","Computer Store","October",12,4,5,5,3,12,452,478,15,26,464,29,493,3,5,2,4,4,3
"Region1","holding","Computer Store","November",12,5,2,3,5,14,322,344,19,22,336,27,363,4,3,3,3,3,3
"Region1","holding","Gaming Zone","January",10,4,2,3,4,11,380,399,15,19,391,23,414,4,4,2,3,4,5
"Region1","holding","Gaming Zone","February",11,4,3,5,3,11,339,362,14,23,350,26,376,3,4,3,2,3,4
"Region1","holding","Gaming Zone","March",13,4,4,5,4,15,493,519,19,26,508,30,538,4,3,4,2,2,2
"Region1","holding","Gaming Zone","April",12,5,2,4,4,12,477,500,16,23,489,27,516,3,2,2,4,4,4
"Region1","holding","Gaming Zone","May",10,2,2,4,3,15,310,328,18,18,325,21,346,5,4,4,3,3,3
"Region1","holding","Gaming Zone","June",10,2,5,4,4,13,429,450,17,21,442,25,467,4,4,3,5,2,3
"Region1","holding","Gaming Zone","July",12,4,4,5,3,11,404,429,14,25,415,28,443,4,4,4,5,3,3
"Region1","holding","Gaming Zone","August",11,4,3,4,2,11,446,468,13,22,457,24,481,4,4,4,4,4,2
"Region1","holding","Gaming Zone","September",13,3,3,2,4,14,351,372,18,21,365,25,390,5,2,3,4,4,3
"Region1","holding","Gaming Zone","October",12,4,3,2,3,13,327,348,16,21,340,24,364,2,3,5,4,3,5
"Region1","holding","Gaming Zone","November",11,3,3,2,4,15,331,350,19,19,346,23,369,3,2,2,4,2,2
"Region1","holding","Super MArket","January",13,3,2,5,3,12,419,442,15,23,431,26,457,5,4,3,4,5,4
"Region1","holding","Super MArket","February",10,2,3,4,5,11,383,402,16,19,394,24,418,5,3,3,4,4,3
"Region1","holding","Super MArket","March",11,4,3,4,4,10,475,497,14,22,485,26,511,5,4,3,4,4,4
"Region1","holding","Super MArket","April",10,4,4,5,3,13,327,350,16,23,340,26,366,5,4,4,2,2,4
"Region1","holding","Super MArket","May",10,4,3,4,3,14,495,516,17,21,509,24,533,5,2,3,5,4,3
"Region1","holding","Super MArket","June",12,5,2,2,4,14,439,460,18,21,453,25,478,4,4,4,4,3,3
"Region1","holding","Super MArket","July",11,4,5,4,4,13,446,470,17,24,459,28,487,3,3,3,4,3,5
"Region1","holding","Super MArket","August",11,5,3,5,2,11,324,348,13,24,335,26,361,4,4,2,5,4,3
"Region1","holding","Super MArket","September",11,3,5,4,5,14,457,480,19,23,471,28,499,3,3,4,3,2,3
"Region1","holding","Super MArket","October",11,5,4,4,3,14,496,520,17,24,510,27,537,5,3,4,3,3,4
"Region1","holding","Super MArket","November",11,3,4,4,2,15,414,436,17,22,429,24,453,3,3,4,5,3,4
"Region1","holding","Fast Food Centre","January",12,4,4,4,4,10,419,443,14,24,429,28,457,4,4,4,4,4,3
"Region1","holding","Fast Food Centre","February",10,5,3,3,5,14,424,445,19,21,438,26,464,3,2,3,4,2,4
"Region1","holding","Fast Food Centre","March",10,4,4,2,4,11,469,489,15,20,480,24,504,2,3,5,3,3,3
"Region1","holding","Fast Food Centre","April",10,4,5,5,4,11,336,360,15,24,347,28,375,4,4,2,2,2,2
"Region1","holding","Fast Food Centre","May",13,4,3,2,3,15,352,374,18,22,367,25,392,3,2,2,3,2,3
"Region1","holding","Fast Food Centre","June",10,5,4,2,3,13,314,335,16,21,327,24,351,2,3,3,4,3,3
"Region1","holding","Fast Food Centre","July",12,2,3,2,3,13,311,330,16,19,324,22,346,5,4,4,3,3,4
"Region1","holding","Fast Food Centre","August",11,3,4,4,2,11,415,437,13,22,426,24,450,3,5,4,4,4,5
"Region1","holding","Fast Food Centre","September",11,4,3,3,5,15,312,333,20,21,327,26,353,3,2,4,2,4,4
"Region1","holding","Fast Food Centre","October",11,5,5,4,4,14,497,522,18,25,511,29,540,2,5,3,4,3,3
"Region1","holding","Fast Food Centre","November",11,4,4,4,4,11,423,446,15,23,434,27,461,2,4,3,2,4,5
"Region2","retail","Retail Store","January",11,5,4,2,2,10,432,454,12,22,442,24,466,5,3,4,4,5,4
"Region2","retail","Retail Store","February",13,3,4,3,3,13,448,471,16,23,461,26,487,2,3,4,5,3,4
"Region2","retail","Retail Store","March",12,5,5,3,3,11,416,441,14,25,427,28,455,3,4,4,3,3,4
"Region2","retail","Retail Store","April",11,5,5,3,5,14,483,507,19,24,497,29,526,3,3,4,5,2,5
"Region2","retail","Retail Store","May",12,5,4,3,3,15,416,440,18,24,431,27,458,3,4,3,2,5,3
"Region2","retail","Retail Store","June",10,5,3,4,4,13,412,434,17,22,425,26,451,4,3,3,4,4,2
"Region2","retail","Retail Store","July",10,3,4,4,4,12,455,476,16,21,467,25,492,4,2,4,3,3,4
"Region2","retail","Retail Store","August",12,5,3,3,3,15,313,336,18,23,328,26,354,4,3,5,2,4,5
"Region2","retail","Retail Store","September",12,2,2,3,2,11,427,446,13,19,438,21,459,3,4,4,2,2,4
"Region2","retail","Retail Store","October",12,4,4,5,3,14,422,447,17,25,436,28,464,4,4,4,2,2,3
"Region2","retail","Retail Store","November",10,3,5,2,5,12,364,384,17,20,376,25,401,2,3,4,2,3,3
"Region2","retail","Kirana Store","January",11,4,5,3,4,15,478,501,19,23,493,27,520,4,3,5,4,3,4
"Region2","retail","Kirana Store","February",12,4,3,3,2,13,436,458,15,22,449,24,473,5,2,4,4,3,4
"Region2","retail","Kirana Store","March",13,5,2,5,3,10,303,328,13,25,313,28,341,3,4,3,3,2,3
"Region2","retail","Kirana Store","April",12,4,5,4,3,10,438,463,13,25,448,28,476,4,4,5,2,5,2
"Region2","retail","Kirana Store","May",11,3,3,4,5,13,310,331,18,21,323,26,349,3,2,2,3,5,2
"Region2","retail","Kirana Store","June",11,4,5,2,3,13,414,436,16,22,427,25,452,4,4,4,4,4,3
"Region2","retail","Kirana Store","July",11,4,2,2,4,13,472,491,17,19,485,23,508,4,3,4,4,2,3
"Region2","retail","Kirana Store","August",12,4,3,4,5,14,477,500,19,23,491,28,519,3,3,5,3,5,3
"Region2","retail","Kirana Store","September",11,3,4,3,4,14,300,321,18,21,314,25,339,2,2,3,3,4,4
"Region2","retail","Kirana Store","October",10,3,3,3,4,13,307,326,17,19,320,23,343,5,4,3,5,2,2
"Region2","retail","Kirana Store","November",13,2,4,4,3,14,476,499,17,23,490,26,516,3,4,3,4,5,5
"Region2","retail","Hotels","January",13,4,4,3,4,15,309,333,19,24,324,28,352,4,5,2,2,4,3
"Region2","retail","Hotels","February",11,5,3,3,4,11,384,406,15,22,395,26,421,4,3,3,5,3,4
"Region2","retail","Hotels","March",12,2,4,2,3,15,328,348,18,20,343,23,366,5,4,3,4,4,4
"Region2","retail","Hotels","April",12,3,2,2,2,12,477,496,14,19,489,21,510,5,4,4,3,2,4
"Region2","retail","Hotels","May",10,5,4,4,2,14,436,459,16,23,450,25,475,2,4,3,4,4,4
"Region2","retail","Hotels","June",12,4,4,5,2,14,476,501,16,25,490,27,517,4,3,3,3,3,4
"Region2","retail","Hotels","July",11,3,3,4,4,12,334,355,16,21,346,25,371,2,3,3,3,3,4
"Region2","retail","Hotels","August",13,5,2,2,3,13,356,378,16,22,369,25,394,3,3,2,4,4,3
"Region2","retail","Hotels","September",12,3,3,4,4,14,371,393,18,22,385,26,411,3,3,4,4,3,4
"Region2","retail","Hotels","October",11,3,4,3,3,11,353,374,14,21,364,24,388,2,4,4,2,3,3
"Region2","retail","Hotels","November",10,4,2,2,5,11,453,471,16,18,464,23,487,3,4,5,3,4,4
"Region2","retail","Restaurants","January",13,3,2,3,5,14,374,395,19,21,388,26,414,4,4,4,3,4,3
"Region2","retail","Restaurants","February",13,4,4,4,4,11,495,520,15,25,506,29,535,2,3,4,4,3,3
"Region2","retail","Restaurants","March",12,3,2,4,3,10,476,497,13,21,486,24,510,2,3,4,3,3,4
"Region2","retail","Restaurants","April",13,3,3,2,4,14,482,503,18,21,496,25,521,5,4,4,5,4,4
"Region2","retail","Restaurants","May",12,2,4,3,3,13,370,391,16,21,383,24,407,3,4,2,3,5,5
"Region2","retail","Restaurants","June",12,4,3,3,5,12,384,406,17,22,396,27,423,5,3,3,3,2,5
"Region2","retail","Restaurants","July",10,2,3,4,3,12,434,453,15,19,446,22,468,4,5,3,4,4,2
"Region2","retail","Restaurants","August",12,2,4,4,4,14,498,520,18,22,512,26,538,4,5,3,4,4,3
"Region2","retail","Restaurants","September",10,5,5,4,4,13,495,519,17,24,508,28,536,4,4,4,3,4,4
"Region2","retail","Restaurants","October",13,4,3,3,3,14,377,400,17,23,391,26,417,2,3,2,3,5,5
"Region2","retail","Restaurants","November",11,4,3,4,5,14,304,326,19,22,318,27,345,3,3,4,2,3,2
"Region2","retail","Airline","January",13,2,3,4,3,10,445,467,13,22,455,25,480,5,3,4,3,4,5
"Region2","retail","Airline","February",11,4,4,4,4,10,466,489,14,23,476,27,503,4,5,3,4,4,3
"Region2","retail","Airline","March",11,3,3,5,4,13,430,452,17,22,443,26,469,4,3,5,3,4,3
"Region2","retail","Airline","April",10,4,3,4,5,10,371,392,15,21,381,26,407,3,2,4,5,2,3
"Region2","retail","Airline","May",12,4,4,4,2,12,443,467,14,24,455,26,481,4,3,4,2,3,3
"Region2","retail","Airline","June",12,2,2,2,3,14,498,516,17,18,512,21,533,3,4,4,3,4,4
"Region2","retail","Airline","July",12,5,4,3,2,10,405,429,12,24,415,26,441,3,5,3,4,3,4
"Region2","retail","Airline","August",12,3,4,3,2,15,340,362,17,22,355,24,379,2,4,2,4,3,4
"Region2","retail","Airline","September",12,4,5,4,3,14,370,395,17,25,384,28,412,4,4,3,3,4,4
"Region2","retail","Airline","October",12,4,3,4,3,14,356,379,17,23,370,26,396,3,4,4,4,3,4
"Region2","retail","Airline","November",10,3,4,3,3,13,395,415,16,20,408,23,431,2,3,2,3,3,4
"Region2","retail","Hardware Store","January",13,4,3,4,4,15,359,383,19,24,374,28,402,4,4,3,4,3,3
"Region2","retail","Hardware Store","February",11,3,3,4,3,13,358,379,16,21,371,24,395,4,3,4,4,3,3
"Region2","retail","Hardware Store","March",12,5,4,3,2,11,481,505,13,24,492,26,518,5,4,4,5,5,3
"Region2","retail","Hardware Store","April",13,4,4,4,4,14,349,374,18,25,363,29,392,4,4,3,5,3,2
"Region2","retail","Hardware Store","May",11,5,2,2,4,12,357,377,16,20,369,24,393,3,4,5,4,3,5
"Region2","retail","Hardware Store","June",12,5,4,2,5,11,300,323,16,23,311,28,339,2,3,3,4,4,5
"Region2","retail","Hardware Store","July",10,4,2,4,4,11,396,416,15,20,407,24,431,3,3,4,4,2,5
"Region2","retail","Hardware Store","August",10,4,3,4,3,11,324,345,14,21,335,24,359,3,2,3,2,3,3
"Region2","retail","Hardware Store","September",12,3,2,2,4,14,362,381,18,19,376,23,399,4,4,4,5,2,3
"Region2","retail","Hardware Store","October",13,3,5,4,3,12,406,431,15,25,418,28,446,3,3,5,3,4,5
"Region2","retail","Hardware Store","November",11,3,4,2,4,13,454,474,17,20,467,24,491,5,4,5,2,2,3
"Region2","retail","Computer Store","January",12,4,5,4,4,13,475,500,17,25,488,29,517,5,4,3,4,3,5
"Region2","retail","Computer Store","February",10,4,4,3,3,11,492,513,14,21,503,24,527,2,3,5,4,4,2
"Region2","retail","Computer Store","March",12,3,3,3,4,12,380,401,16,21,392,25,417,3,5,2,4,3,2
"Region2","retail","Computer Store","April",12,3,4,4,4,12,434,457,16,23,446,27,473,4,4,2,5,4,4
"Region2","retail","Computer Store","May",12,3,5,4,3,14,326,350,17,24,340,27,367,2,2,4,4,3,3
"Region2","retail","Computer Store","June",11,3,4,3,5,14,476,497,19,21,490,26,516,4,2,4,5,4,3
"Region2","retail","Computer Store","July",11,5,5,3,4,15,472,496,19,24,487,28,515,2,4,2,2,2,4
"Region2","retail","Computer Store","August",11,3,4,4,4,13,462,484,17,22,475,26,501,5,4,4,3,3,5
"Region2","retail","Computer Store","September",11,3,4,2,3,13,410,430,16,20,423,23,446,2,3,4,4,3,4
"Region2","retail","Computer Store","October",13,4,5,4,5,14,301,327,19,26,315,31,346,3,3,4,2,3,4
"Region2","retail","Computer Store","November",12,2,4,4,4,13,441,463,17,22,454,26,480,2,4,4,4,4,5
"Region2","retail","Gaming Zone","January",13,3,2,3,5,12,340,361,17,21,352,26,378,3,4,5,2,2,4
"Region2","retail","Gaming Zone","February",10,4,4,2,2,14,421,441,16,20,435,22,457,2,4,4,5,3,3
"Region2","retail","Gaming Zone","March",13,5,3,3,3,12,457,481,15,24,469,27,496,3,5,4,3,2,4
"Region2","retail","Gaming Zone","April",12,5,3,3,2,12,486,509,14,23,498,25,523,4,3,4,4,3,2
"Region2","retail","Gaming Zone","May",11,3,5,4,4,14,472,495,18,23,486,27,513,3,4,3,3,5,4
"Region2","retail","Gaming Zone","June",13,5,5,4,3,14,478,505,17,27,492,30,522,4,5,4,3,3,4
"Region2","retail","Gaming Zone","July",11,4,2,2,4,12,394,413,16,19,406,23,429,3,5,5,4,3,3
"Region2","retail","Gaming Zone","August",11,5,5,4,5,11,372,397,16,25,383,30,413,3,4,2,2,3,5
"Region2","retail","Gaming Zone","September",12,4,3,3,3,13,439,461,16,22,452,25,477,4,4,4,3,3,2
"Region2","retail","Gaming Zone","October",13,3,3,3,3,10,470,492,13,22,480,25,505,4,3,3,2,4,4
"Region2","retail","Gaming Zone","November",12,5,5,4,5,10,416,442,15,26,426,31,457,3,3,2,3,4,3
"Region2","retail","Super MArket","January",11,3,4,3,4,13,349,370,17,21,362,25,387,3,4,3,3,2,4
"Region2","retail","Super MArket","February",10,3,2,4,4,14,451,470,18,19,465,23,488,4,5,4,2,4,4
"Region2","retail","Super MArket","March",12,4,3,4,2,12,472,495,14,23,484,25,509,5,3,3,4,4,4
"Region2","retail","Super MArket","April",11,5,4,4,4,13,450,474,17,24,463,28,491,3,4,2,2,4,5
"Region2","retail","Super MArket","May",11,4,5,5,4,13,483,508,17,25,496,29,525,4,3,5,3,3,3
"Region2","retail","Super MArket","June",10,3,3,3,3,14,314,333,17,19,328,22,350,5,4,5,4,4,4
"Region2","retail","Super MArket","July",12,3,5,5,4,12,417,442,16,25,429,29,458,3,3,4,2,2,2
"Region2","retail","Super MArket","August",10,2,3,4,3,14,483,502,17,19,497,22,519,4,4,4,2,4,4
"Region2","retail","Super MArket","September",13,4,4,4,4,10,490,515,14,25,500,29,529,3,3,4,3,4,3
"Region2","retail","Super MArket","October",11,4,5,4,5,14,478,502,19,24,492,29,521,5,3,2,2,3,3
"Region2","retail","Super MArket","November",11,5,5,4,3,15,395,420,18,25,410,28,438,2,4,4,4,5,3
"Region2","retail","Fast Food Centre","January",12,3,3,3,3,12,446,467,15,21,458,24,482,3,2,4,5,4,4
"Region2","retail","Fast Food Centre","February",12,3,4,3,5,14,367,389,19,22,381,27,408,4,4,2,4,3,3
"Region2","retail","Fast Food Centre","March",12,3,5,4,3,15,447,471,18,24,462,27,489,4,4,2,3,3,3
"Region2","retail","Fast Food Centre","April",11,3,4,4,4,15,439,461,19,22,454,26,480,4,2,2,4,4,2
"Region2","retail","Fast Food Centre","May",10,3,3,4,4,10,352,372,14,20,362,24,386,4,5,4,2,2,4
"Region2","retail","Fast Food Centre","June",13,4,3,2,3,12,312,334,15,22,324,25,349,4,4,4,4,5,2
"Region2","retail","Fast Food Centre","July",13,4,5,2,3,10,372,396,13,24,382,27,409,4,2,4,2,3,5
"Region2","retail","Fast Food Centre","August",10,3,5,5,3,12,450,473,15,23,462,26,488,4,2,3,3,3,4
"Region2","retail","Fast Food Centre","September",10,4,4,4,2,11,468,490,13,22,479,24,503,2,3,5,4,4,2
"Region2","retail","Fast Food Centre","October",12,3,4,5,3,15,323,347,18,24,338,27,365,4,3,3,3,2,5
"Region2","retail","Fast Food Centre","November",10,3,3,5,4,14,492,513,18,21,506,25,531,2,2,5,4,4,5
"Region2","holding","Retail Store","January",12,3,2,3,3,15,460,480,18,20,475,23,498,4,4,4,5,3,3
"Region2","holding","Retail Store","February",11,3,3,4,4,11,393,414,15,21,404,25,429,3,3,2,4,3,3
"Region2","holding","Retail Store","March",12,4,4,2,4,12,370,392,16,22,382,26,408,3,4,3,3,4,5
"Region2","holding","Retail Store","April",10,3,5,2,4,12,391,411,16,20,403,24,427,4,4,4,4,3,4
"Region2","holding","Retail Store","May",10,2,5,5,4,15,427,449,19,22,442,26,468,5,4,4,4,5,4
"Region2","holding","Retail Store","June",11,3,2,2,5,11,323,341,16,18,334,23,357,4,5,3,5,2,3
"Region2","holding","Retail Store","July",11,4,2,5,5,13,417,439,18,22,430,27,457,4,3,3,3,2,3
"Region2","holding","Retail Store","August",11,4,4,4,4,11,407,430,15,23,418,27,445,3,5,5,4,2,3
"Region2","holding","Retail Store","September",13,2,4,5,4,13,401,425,17,24,414,28,442,2,5,4,3,5,3
"Region2","holding","Retail Store","October",12,4,4,4,4,13,369,393,17,24,382,28,410,2,3,3,5,3,3
"Region2","holding","Retail Store","November",10,3,3,3,2,11,452,471,13,19,463,21,484,3,3,4,4,4,3
"Region2","holding","Kirana Store","January",12,5,4,4,3,14,326,351,17,25,340,28,368,2,3,3,4,4,3
"Region2","holding","Kirana Store","February",12,5,5,3,4,14,489,514,18,25,503,29,532,2,4,2,4,3,3
"Region2","holding","Kirana Store","March",12,3,3,4,5,11,449,471,16,22,460,27,487,4,3,4,4,4,4
"Region2","holding","Kirana Store","April",12,5,4,4,4,12,493,518,16,25,505,29,534,4,4,4,4,3,3
"Region2","holding","Kirana Store","May",13,3,3,3,3,11,320,342,14,22,331,25,356,4,4,4,3,3,5
"Region2","holding","Kirana Store","June",11,4,4,4,4,11,310,333,15,23,321,27,348,3,5,2,5,2,2
"Region2","holding","Kirana Store","July",12,2,2,4,4,12,453,473,16,20,465,24,489,3,4,3,2,3,5
"Region2","holding","Kirana Store","August",10,4,4,3,4,11,441,462,15,21,452,25,477,4,3,4,5,4,4
"Region2","holding","Kirana Store","September",13,5,3,4,2,11,436,461,13,25,447,27,474,4,3,2,2,2,3
"Region2","holding","Kirana Store","October",12,4,2,2,4,13,403,423,17,20,416,24,440,2,4,4,4,2,3
"Region2","holding","Kirana Store","November",12,3,5,4,4,14,331,355,18,24,345,28,373,3,2,3,5,3,5
"Region2","holding","Hotels","January",12,3,2,3,4,11,453,473,15,20,464,24,488,2,4,4,5,2,2
"Region2","holding","Hotels","February",12,2,3,3,3,15,381,401,18,20,396,23,419,2,2,3,3,3,2
"Region2","holding","Hotels","March",11,3,5,4,4,11,384,407,15,23,395,27,422,5,3,2,4,3,3
"Region2","holding","Hotels","April",11,4,5,5,2,15,327,352,17,25,342,27,369,3,4,4,5,4,3
"Region2","holding","Hotels","May",10,4,3,4,4,11,438,459,15,21,449,25,474,2,4,2,2,4,5
"Region2","holding","Hotels","June",10,3,3,3,4,14,342,361,18,19,356,23,379,3,2,4,4,5,4
"Region2","holding","Hotels","July",12,4,3,3,5,10,399,421,15,22,409,27,436,3,2,5,5,4,3
"Region2","holding","Hotels","August",11,5,3,4,3,10,412,435,13,23,422,26,448,3,2,2,3,2,3
"Region2","holding","Hotels","September",12,3,5,3,4,15,317,340,19,23,332,27,359,4,2,3,3,2,3
"Region2","holding","Hotels","October",12,3,2,4,4,12,368,389,16,21,380,25,405,4,4,2,2,3,5
"Region2","holding","Hotels","November",10,2,3,3,3,12,498,516,15,18,510,21,531,5,4,4,3,2,4
"Region2","holding","Restaurants","January",10,3,2,4,3,14,416,435,17,19,430,22,452,3,2,4,2,4,2
"Region2","holding","Restaurants","February",12,4,3,3,3,10,466,488,13,22,476,25,501,2,4,3,5,4,3
"Region2","holding","Restaurants","March",10,4,3,2,3,14,426,445,17,19,440,22,462,5,3,3,5,5,2
"Region2","holding","Restaurants","April",13,3,3,5,2,13,430,454,15,24,443,26,469,5,2,4,3,4,3
"Region2","holding","Restaurants","May",11,5,2,2,3,14,404,424,17,20,418,23,441,3,3,4,2,2,2
"Region2","holding","Restaurants","June",11,5,3,3,2,10,393,415,12,22,403,24,427,3,4,3,3,4,4
"Region2","holding","Restaurants","July",11,3,4,3,5,13,301,322,18,21,314,26,340,2,4,3,4,3,4
"Region2","holding","Restaurants","August",12,3,2,3,3,14,317,337,17,20,331,23,354,4,4,4,5,3,5
"Region2","holding","Restaurants","September",12,4,2,3,3,14,383,404,17,21,397,24,421,4,3,2,4,4,2
"Region2","holding","Restaurants","October",12,2,4,4,5,14,378,400,19,22,392,27,419,2,3,4,4,4,3
"Region2","holding","Restaurants","November",11,4,4,2,2,11,460,481,13,21,471,23,494,2,2,4,4,2,5
"Region2","holding","Airline","January",12,4,3,4,5,12,491,514,17,23,503,28,531,3,3,4,3,3,2
"Region2","holding","Airline","February",13,5,4,4,3,14,447,473,17,26,461,29,490,4,2,2,3,4,3
"Region2","holding","Airline","March",12,5,3,4,4,11,466,490,15,24,477,28,505,3,4,4,3,2,2
"Region2","holding","Airline","April",13,2,2,3,2,14,396,416,16,20,410,22,432,3,2,4,4,3,3
"Region2","holding","Airline","May",13,3,3,5,2,15,305,329,17,24,320,26,346,3,5,3,4,4,5
"Region2","holding","Airline","June",13,5,2,5,3,10,324,349,13,25,334,28,362,2,2,2,4,3,2
"Region2","holding","Airline","July",12,2,4,4,2,12,303,325,14,22,315,24,339,3,3,4,3,5,3
"Region2","holding","Airline","August",11,3,3,2,4,12,482,501,16,19,494,23,517,2,2,4,3,4,3
"Region2","holding","Airline","September",11,4,4,2,4,14,476,497,18,21,490,25,515,2,2,3,3,3,3
"Region2","holding","Airline","October",13,5,5,3,2,13,371,397,15,26,384,28,412,4,3,5,5,2,5
"Region2","holding","Airline","November",12,5,5,2,3,11,479,503,14,24,490,27,517,3,4,3,3,5,4
"Region2","holding","Hardware Store","January",11,2,5,3,2,11,389,410,13,21,400,23,423,3,4,3,3,3,3
"Region2","holding","Hardware Store","February",12,4,2,4,3,13,494,516,16,22,507,25,532,4,5,3,5,5,3
"Region2","holding","Hardware Store","March",11,4,2,4,5,10,361,382,15,21,371,26,397,3,5,4,4,4,5
"Region2","holding","Hardware Store","April",11,3,4,2,3,14,406,426,17,20,420,23,443,3,3,5,3,4,4
"Region2","holding","Hardware Store","May",13,3,4,4,4,10,462,486,14,24,472,28,500,4,4,2,3,3,4
"Region2","holding","Hardware Store","June",11,5,4,4,4,14,331,355,18,24,345,28,373,2,3,4,2,4,3
"Region2","holding","Hardware Store","July",11,2,3,3,3,14,305,324,17,19,319,22,341,2,3,5,4,3,4
"Region2","holding","Hardware Store","August",11,4,5,5,5,14,405,430,19,25,419,30,449,4,3,4,3,5,2
"Region2","holding","Hardware Store","September",13,5,3,4,4,11,302,327,15,25,313,29,342,3,4,3,5,5,5
"Region2","holding","Hardware Store","October",10,3,3,3,4,12,450,469,16,19,462,23,485,2,3,5,5,3,5
"Region2","holding","Hardware Store","November",11,2,5,4,5,10,461,483,15,22,471,27,498,4,3,3,5,4,2
"Region2","holding","Computer Store","January",11,4,5,4,3,11,322,346,14,24,333,27,360,2,4,2,4,5,3
"Region2","holding","Computer Store","February",11,4,4,2,3,11,318,339,14,21,329,24,353,5,3,3,3,3,5
"Region2","holding","Computer Store","March",12,5,2,3,3,14,434,456,17,22,448,25,473,4,5,5,2,2,3
"Region2","holding","Computer Store","April",12,5,2,3,2,14,389,411,16,22,403,24,427,4,4,5,2,4,5
"Region2","holding","Computer Store","May",11,4,4,3,3,10,388,410,13,22,398,25,423,3,2,3,2,3,3
"Region2","holding","Computer Store","June",12,3,2,4,3,15,367,388,18,21,382,24,406,3,4,4,2,2,4
"Region2","holding","Computer Store","July",13,4,4,4,4,11,405,430,15,25,416,29,445,4,3,2,4,4,4
"Region2","holding","Computer Store","August",13,4,5,5,5,15,335,362,20,27,350,32,382,3,4,5,3,3,4
"Region2","holding","Computer Store","September",13,2,2,4,3,10,485,506,13,21,495,24,519,5,5,4,4,5,5
"Region2","holding","Computer Store","October",12,2,4,2,4,14,372,392,18,20,386,24,410,4,4,4,2,4,3
"Region2","holding","Computer Store","November",12,4,5,3,3,13,313,337,16,24,326,27,353,4,3,2,4,3,4
"Region2","holding","Gaming Zone","January",11,3,4,4,4,11,313,335,15,22,324,26,350,4,4,3,2,3,5
"Region2","holding","Gaming Zone","February",12,4,5,3,5,14,394,418,19,24,408,29,437,5,2,5,2,2,2
"Region2","holding","Gaming Zone","March",11,3,3,2,4,14,368,387,18,19,382,23,405,3,4,4,3,3,4
"Region2","holding","Gaming Zone","April",11,4,3,4,3,13,450,472,16,22,463,25,488,4,3,4,5,5,5
"Region2","holding","Gaming Zone","May",12,3,2,5,4,14,418,440,18,22,432,26,458,3,3,3,3,4,5
"Region2","holding","Gaming Zone","June",10,5,3,5,3,12,486,509,15,23,498,26,524,4,3,4,2,3,5
"Region2","holding","Gaming Zone","July",10,2,2,4,2,14,412,430,16,18,426,20,446,2,4,5,3,5,4
"Region2","holding","Gaming Zone","August",12,2,4,4,3,10,388,410,13,22,398,25,423,3,5,3,3,4,3
"Region2","holding","Gaming Zone","September",10,4,3,4,5,13,309,330,18,21,322,26,348,4,5,4,4,3,4
"Region2","holding","Gaming Zone","October",11,3,3,3,2,11,441,461,13,20,452,22,474,2,4,4,2,3,4
"Region2","holding","Gaming Zone","November",10,5,2,4,3,14,422,443,17,21,436,24,460,3,3,4,2,4,3
"Region2","holding","Super MArket","January",11,3,3,3,4,12,453,473,16,20,465,24,489,4,2,2,5,4,4
"Region2","holding","Super MArket","February",12,4,4,3,3,14,365,388,17,23,379,26,405,2,3,4,4,4,3
"Region2","holding","Super MArket","March",12,3,3,2,3,15,384,404,18,20,399,23,422,4,5,4,3,5,4
"Region2","holding","Super MArket","April",11,4,3,3,3,12,328,349,15,21,340,24,364,3,3,4,3,2,5
"Region2","holding","Super MArket","May",12,4,2,4,4,12,382,404,16,22,394,26,420,3,3,4,4,4,4
"Region2","holding","Super MArket","June",12,4,5,5,3,11,398,424,14,26,409,29,438,4,3,5,3,5,3
"Region2","holding","Super MArket","July",10,5,4,5,4,14,440,464,18,24,454,28,482,4,3,4,4,3,5
"Region2","holding","Super MArket","August",11,4,3,3,4,14,424,445,18,21,438,25,463,3,3,3,3,3,4
"Region2","holding","Super MArket","September",11,4,2,5,2,14,354,376,16,22,368,24,392,4,3,4,3,3,5
"Region2","holding","Super MArket","October",13,5,5,5,3,14,431,459,17,28,445,31,476,5,3,4,2,4,2
"Region2","holding","Super MArket","November",13,5,3,4,2,10,367,392,12,25,377,27,404,2,4,3,4,2,3
"Region2","holding","Fast Food Centre","January",11,3,4,4,3,13,336,358,16,22,349,25,374,2,3,4,2,4,3
"Region2","holding","Fast Food Centre","February",11,4,5,5,4,13,336,361,17,25,349,29,378,3,3,4,5,4,5
"Region2","holding","Fast Food Centre","March",12,2,3,3,4,14,415,435,18,20,429,24,453,4,3,3,4,2,4
"Region2","holding","Fast Food Centre","April",12,4,3,3,3,15,405,427,18,22,420,25,445,3,4,4,3,5,2
"Region2","holding","Fast Food Centre","May",12,4,2,4,2,13,500,522,15,22,513,24,537,5,3,4,4,2,2
"Region2","holding","Fast Food Centre","June",12,4,3,5,3,11,402,426,14,24,413,27,440,4,5,4,5,2,4
"Region2","holding","Fast Food Centre","July",11,4,3,3,2,12,341,362,14,21,353,23,376,5,3,4,4,4,4
"Region2","holding","Fast Food Centre","August",12,5,4,4,5,14,326,351,19,25,340,30,370,4,5,4,3,3,5
"Region2","holding","Fast Food Centre","September",11,5,3,3,3,11,411,433,14,22,422,25,447,3,2,2,5,3,2
"Region2","holding","Fast Food Centre","October",12,5,4,2,3,12,304,327,15,23,316,26,342,3,3,3,3,4,3
"Region2","holding","Fast Food Centre","November",12,5,5,4,4,12,399,425,16,26,411,30,441,5,4,3,2,3,3
"Region3","retail","Retail Store","January",10,4,5,2,3,14,454,475,17,21,468,24,492,2,3,2,4,5,5
"Region3","retail","Retail Store","February",12,4,5,3,4,11,428,452,15,24,439,28,467,2,3,2,2,2,4
"Region3","retail","Retail Store","March",10,3,3,5,5,14,399,420,19,21,413,26,439,3,4,4,5,3,2
"Region3","retail","Retail Store","April",13,4,3,2,2,10,404,426,12,22,414,24,438,5,5,3,3,4,4
"Region3","retail","Retail Store","May",12,3,4,3,4,13,405,427,17,22,418,26,444,3,3,3,2,4,5
"Region3","retail","Retail Store","June",11,5,2,4,3,14,309,331,17,22,323,25,348,3,4,5,2,3,5
"Region3","retail","Retail Store","July",11,4,4,3,5,11,418,440,16,22,429,27,456,5,3,4,3,4,5
"Region3","retail","Retail Store","August",11,4,2,3,5,10,382,402,15,20,392,25,417,3,3,3,3,3,3
"Region3","retail","Retail Store","September",11,5,4,4,4,10,385,409,14,24,395,28,423,4,4,5,3,5,4
"Region3","retail","Retail Store","October",10,4,4,2,4,11,400,420,15,20,411,24,435,3,5,3,3,4,2
"Region3","retail","Retail Store","November",12,3,4,5,4,15,405,429,19,24,420,28,448,2,2,5,4,4,4
"Region3","retail","Kirana Store","January",11,3,3,4,2,14,391,412,16,21,405,23,428,4,4,3,3,3,4
"Region3","retail","Kirana Store","February",11,4,2,3,3,14,463,483,17,20,477,23,500,3,2,3,4,4,4
"Region3","retail","Kirana Store","March",11,3,3,2,3,13,363,382,16,19,376,22,398,2,4,5,4,4,3
"Region3","retail","Kirana Store","April",11,5,4,5,4,13,300,325,17,25,313,29,342,4,4,4,4,5,3
"Region3","retail","Kirana Store","May",12,4,4,2,4,11,394,416,15,22,405,26,431,3,4,4,5,4,4
"Region3","retail","Kirana Store","June",11,5,3,4,4,13,499,522,17,23,512,27,539,3,2,3,4,5,5
"Region3","retail","Kirana Store","July",12,2,3,2,2,13,483,502,15,19,496,21,517,3,2,2,3,3,4
"Region3","retail","Kirana Store","August",10,4,3,5,4,12,499,521,16,22,511,26,537,2,4,4,4,5,2
"Region3","retail","Kirana Store","September",11,3,4,3,2,15,451,472,17,21,466,23,489,3,5,3,4,2,4
"Region3","retail","Kirana Store","October",12,2,3,3,2,10,345,365,12,20,355,22,377,3,4,4,2,2,3
"Region3","retail","Kirana Store","November",10,2,2,5,4,14,438,457,18,19,452,23,475,4,3,5,2,4,4
"Region3","retail","Hotels","January",13,5,2,4,4,12,486,510,16,24,498,28,526,2,4,5,4,4,4
"Region3","retail","Hotels","February",10,4,2,4,2,14,304,324,16,20,318,22,340,4,2,4,2,5,4
"Region3","retail","Hotels","March",11,2,3,4,3,15,406,426,18,20,421,23,444,2,4,5,3,4,4
"Region3","retail","Hotels","April",10,3,5,3,4,14,445,466,18,21,459,25,484,2,4,5,2,4,5
"Region3","retail","Hotels","May",11,4,2,5,3,12,360,382,15,22,372,25,397,4,2,5,5,3,3
"Region3","retail","Hotels","June",12,2,5,3,2,12,428,450,14,22,440,24,464,5,4,3,4,5,3
"Region3","retail","Hotels","July",12,2,3,3,4,11,399,419,15,20,410,24,434,5,5,3,3,4,3
"Region3","retail","Hotels","August",11,4,2,5,5,13,478,500,18,22,491,27,518,4,5,5,3,5,4
"Region3","retail","Hotels","September",11,3,3,4,5,13,398,419,18,21,411,26,437,4,2,5,5,4,3
"Region3","retail","Hotels","October",11,5,5,4,3,14,432,457,17,25,446,28,474,5,4,3,2,3,3
"Region3","retail","Hotels","November",13,2,3,3,4,13,381,402,17,21,394,25,419,4,4,2,3,5,3
"Region3","retail","Restaurants","January",12,4,3,3,4,14,414,436,18,22,428,26,454,4,3,3,3,3,3
"Region3","retail","Restaurants","February",11,3,3,3,5,13,317,337,18,20,330,25,355,5,3,4,4,3,3
"Region3","retail","Restaurants","March",12,5,5,3,3,12,302,327,15,25,314,28,342,4,2,3,2,3,3
"Region3","retail","Restaurants","April",13,3,4,3,3,14,464,487,17,23,478,26,504,4,4,3,3,5,3
"Region3","retail","Restaurants","May",10,5,3,2,3,13,492,512,16,20,505,23,528,5,4,5,4,2,3
"Region3","retail","Restaurants","June",12,3,2,5,3,12,311,333,15,22,323,25,348,4,4,3,2,2,2
"Region3","retail","Restaurants","July",10,4,2,4,4,11,334,354,15,20,345,24,369,3,4,4,5,4,5
"Region3","retail","Restaurants","August",13,4,2,3,4,14,414,436,18,22,428,26,454,4,4,4,3,3,3
"Region3","retail","Restaurants","September",13,4,3,3,2,11,355,378,13,23,366,25,391,2,3,3,3,5,4
"Region3","retail","Restaurants","October",13,2,3,4,5,12,412,434,17,22,424,27,451,5,5,3,4,2,5
"Region3","retail","Restaurants","November",11,3,5,5,4,10,449,473,14,24,459,28,487,3,4,4,5,4,3
"Region3","retail","Airline","January",11,3,4,5,3,15,460,483,18,23,475,26,501,3,4,3,5,4,5
"Region3","retail","Airline","February",11,4,4,2,4,14,498,519,18,21,512,25,537,5,2,3,4,3,3
"Region3","retail","Airline","March",10,3,3,3,3,14,476,495,17,19,490,22,512,5,3,4,3,2,5
"Region3","retail","Airline","April",12,3,5,2,4,13,477,499,17,22,490,26,516,4,4,5,3,4,5
"Region3","retail","Airline","May",11,4,3,5,4,10,377,400,14,23,387,27,414,5,3,5,2,4,3
"Region3","retail","Airline","June",11,4,4,3,4,11,413,435,15,22,424,26,450,5,4,5,4,2,3
"Region3","retail","Airline","July",11,5,3,3,4,13,356,378,17,22,369,26,395,3,5,5,3,2,2
"Region3","retail","Airline","August",12,4,3,3,3,11,384,406,14,22,395,25,420,4,5,4,4,2,5
"Region3","retail","Airline","September",11,2,5,4,4,12,448,470,16,22,460,26,486,4,4,3,3,4,2
"Region3","retail","Airline","October",11,4,4,3,5,14,348,370,19,22,362,27,389,3,3,4,4,4,3
"Region3","retail","Airline","November",12,4,3,3,3,12,354,376,15,22,366,25,391,4,4,4,2,3,4
"Region3","retail","Hardware Store","January",12,5,3,4,5,14,413,437,19,24,427,29,456,5,4,4,3,3,2
"Region3","retail","Hardware Store","February",13,4,3,4,3,11,488,512,14,24,499,27,526,4,5,2,2,4,3
"Region3","retail","Hardware Store","March",13,4,5,4,4,11,469,495,15,26,480,30,510,3,3,4,3,5,4
"Region3","retail","Hardware Store","April",12,4,3,4,4,14,367,390,18,23,381,27,408,2,2,4,5,5,2
"Region3","retail","Hardware Store","May",11,4,4,4,4,11,372,395,15,23,383,27,410,5,4,4,4,4,2
"Region3","retail","Hardware Store","June",11,3,3,3,5,14,335,355,19,20,349,25,374,3,3,2,4,3,2
"Region3","retail","Hardware Store","July",10,4,4,4,5,10,447,469,15,22,457,27,484,2,4,5,2,3,2
"Region3","retail","Hardware Store","August",11,3,5,5,3,13,499,523,16,24,512,27,539,3,3,4,3,3,5
"Region3","retail","Hardware Store","September",10,4,5,3,4,11,328,350,15,22,339,26,365,5,4,4,4,4,5
"Region3","retail","Hardware Store","October",12,2,3,3,3,11,314,334,14,20,325,23,348,4,2,3,2,2,4
"Region3","retail","Hardware Store","November",12,4,2,5,2,11,453,476,13,23,464,25,489,3,5,3,4,4,3
"Region3","retail","Computer Store","January",13,4,3,3,5,13,498,521,18,23,511,28,539,4,2,2,3,4,4
"Region3","retail","Computer Store","February",10,4,4,2,3,13,426,446,16,20,439,23,462,3,4,3,3,2,4
"Region3","retail","Computer Store","March",12,4,4,4,3,13,434,458,16,24,447,27,474,3,3,3,4,3,5
"Region3","retail","Computer Store","April",13,3,2,2,3,11,328,348,14,20,339,23,362,2,3,5,4,4,4
"Region3","retail","Computer Store","May",12,4,4,3,5,15,454,477,20,23,469,28,497,4,5,2,2,3,4
"Region3","retail","Computer Store","June",12,2,5,4,2,14,328,351,16,23,342,25,367,5,2,4,5,3,3
"Region3","retail","Computer Store","July",13,4,5,2,2,11,334,358,13,24,345,26,371,3,2,4,3,2,2
"Region3","retail","Computer Store","August",11,3,2,3,4,11,452,471,15,19,463,23,486,2,5,3,2,4,4
"Region3","retail","Computer Store","September",12,5,4,3,2,11,302,326,13,24,313,26,339,3,5,4,4,4,2
"Region3","retail","Computer Store","October",13,5,4,5,2,13,484,511,15,27,497,29,526,3,4,3,3,5,3
"Region3","retail","Computer Store","November",13,4,4,4,4,14,379,404,18,25,393,29,422,4,2,4,5,2,5
"Region3","retail","Gaming Zone","January",11,4,3,4,4,13,399,421,17,22,412,26,438,3,2,3,3,5,3
"Region3","retail","Gaming Zone","February",12,3,4,3,2,14,384,406,16,22,398,24,422,2,4,4,2,2,4
"Region3","retail","Gaming Zone","March",10,5,5,3,4,10,437,460,14,23,447,27,474,4,4,3,3,5,4
"Region3","retail","Gaming Zone","April",10,5,4,4,4,13,396,419,17,23,409,27,436,4,4,2,4,3,3
"Region3","retail","Gaming Zone","May",10,5,3,3,5,13,431,452,18,21,444,26,470,4,3,2,3,3,4
"Region3","retail","Gaming Zone","June",12,5,4,3,2,12,305,329,14,24,317,26,343,4,3,2,3,3,4
"Region3","retail","Gaming Zone","July",11,4,2,4,3,11,343,364,14,21,354,24,378,4,2,3,2,5,4
"Region3","retail","Gaming Zone","August",10,3,5,2,4,14,465,485,18,20,479,24,503,5,3,4,3,3,3
"Region3","retail","Gaming Zone","September",12,4,4,5,2,13,354,379,15,25,367,27,394,4,4,4,5,3,3
"Region3","retail","Gaming Zone","October",11,2,4,3,4,11,488,508,15,20,499,24,523,5,5,5,5,5,5
"Region3","retail","Gaming Zone","November",11,4,3,2,5,13,434,454,18,20,447,25,472,5,3,2,4,2,2
"Region3","retail","Super MArket","January",11,3,3,2,4,14,443,462,18,19,457,23,480,3,3,4,4,5,3
"Region3","retail","Super MArket","February",10,3,4,2,3,14,387,406,17,19,401,22,423,3,2,4,3,5,3
"Region3","retail","Super MArket","March",11,4,5,3,5,11,494,517,16,23,505,28,533,4,4,3,5,5,2
"Region3","retail","Super MArket","April",11,4,4,3,4,11,373,395,15,22,384,26,410,2,4,4,5,2,3
"Region3","retail","Super MArket","May",12,3,4,2,5,13,467,488,18,21,480,26,506,4,2,2,4,4,5
"Region3","retail","Super MArket","June",12,4,3,2,4,11,484,505,15,21,495,25,520,3,4,3,4,3,5
"Region3","retail","Super MArket","July",12,5,4,4,5,13,466,491,18,25,479,30,509,5,4,4,2,2,4
"Region3","retail","Super MArket","August",10,4,5,2,3,14,353,374,17,21,367,24,391,3,5,4,4,5,4
"Region3","retail","Super MArket","September",12,3,4,4,3,14,437,460,17,23,451,26,477,4,3,3,3,2,4
"Region3","retail","Super MArket","October",11,3,5,3,3,14,341,363,17,22,355,25,380,3,3,2,3,4,3
"Region3","retail","Super MArket","November",12,4,4,4,5,14,393,417,19,24,407,29,436,3,5,2,4,3,4
"Region3","retail","Fast Food Centre","January",11,4,2,5,4,11,323,345,15,22,334,26,360,3,4,3,2,5,4
"Region3","retail","Fast Food Centre","February",11,4,4,2,3,15,374,395,18,21,389,24,413,3,4,4,2,3,3
"Region3","retail","Fast Food Centre","March",10,5,3,3,2,11,428,449,13,21,439,23,462,4,4,5,4,5,3
"Region3","retail","Fast Food Centre","April",12,5,3,3,2,13,361,384,15,23,374,25,399,4,3,2,4,5,4
"Region3","retail","Fast Food Centre","May",12,5,2,5,2,12,473,497,14,24,485,26,511,4,3,3,3,3,2
"Region3","retail","Fast Food Centre","June",11,4,3,4,2,11,360,382,13,22,371,24,395,5,5,4,2,3,4
"Region3","retail","Fast Food Centre","July",13,5,4,2,3,11,302,326,14,24,313,27,340,3,2,3,5,3,4
"Region3","retail","Fast Food Centre","August",11,4,3,3,3,15,337,358,18,21,352,24,376,5,2,3,3,4,3
"Region3","retail","Fast Food Centre","September",12,2,4,4,4,12,330,352,16,22,342,26,368,4,2,4,4,2,4
"Region3","retail","Fast Food Centre","October",11,3,3,3,4,13,310,330,17,20,323,24,347,2,4,3,5,3,4
"Region3","retail","Fast Food Centre","November",11,3,4,4,4,14,435,457,18,22,449,26,475,3,4,2,3,5,4
"Region3","holding","Retail Store","January",13,5,2,4,4,12,420,444,16,24,432,28,460,3,2,4,4,3,2
"Region3","holding","Retail Store","February",11,5,5,4,4,13,406,431,17,25,419,29,448,4,3,3,4,3,4
"Region3","holding","Retail Store","March",12,3,4,3,3,13,483,505,16,22,496,25,521,3,3,4,2,3,4
"Region3","holding","Retail Store","April",12,4,4,4,2,13,399,423,15,24,412,26,438,4,5,3,5,4,2
"Region3","holding","Retail Store","May",11,3,3,3,4,14,470,490,18,20,484,24,508,3,5,3,3,3,5
"Region3","holding","Retail Store","June",12,5,3,3,3,12,482,505,15,23,494,26,520,3,5,2,4,3,4
"Region3","holding","Retail Store","July",12,2,5,2,4,10,364,385,14,21,374,25,399,3,2,3,4,4,5
"Region3","holding","Retail Store","August",12,5,5,3,3,11,436,461,14,25,447,28,475,4,2,2,3,5,3
"Region3","holding","Retail Store","September",11,2,4,2,3,13,462,481,16,19,475,22,497,5,4,4,3,4,4
"Region3","holding","Retail Store","October",13,4,2,4,3,13,464,487,16,23,477,26,503,3,4,3,4,3,4
"Region3","holding","Retail Store","November",10,4,3,5,4,14,391,413,18,22,405,26,431,4,5,4,2,4,4
"Region3","holding","Kirana Store","January",13,2,3,4,5,12,489,511,17,22,501,27,528,4,2,4,4,4,3
"Region3","holding","Kirana Store","February",11,3,4,4,4,12,431,453,16,22,443,26,469,3,2,4,5,3,5
"Region3","holding","Kirana Store","March",12,4,2,3,2,10,335,356,12,21,345,23,368,3,5,2,2,5,5
"Region3","holding","Kirana Store","April",11,3,5,4,5,11,481,504,16,23,492,28,520,2,5,5,4,3,3
"Region3","holding","Kirana Store","May",11,3,4,3,5,13,481,502,18,21,494,26,520,2,4,4,2,3,5
"Region3","holding","Kirana Store","June",11,2,4,2,3,11,403,422,14,19,414,22,436,3,5,3,2,5,3
"Region3","holding","Kirana Store","July",12,5,2,5,4,14,416,440,18,24,430,28,458,3,2,5,3,5,5
"Region3","holding","Kirana Store","August",11,3,4,2,5,11,373,393,16,20,384,25,409,4,4,4,5,4,2
"Region3","holding","Kirana Store","September",12,5,4,3,4,13,317,341,17,24,330,28,358,3,2,3,4,2,5
"Region3","holding","Kirana Store","October",12,4,5,5,5,12,416,442,17,26,428,31,459,3,2,4,5,4,4
"Region3","holding","Kirana Store","November",12,4,3,4,4,15,376,399,19,23,391,27,418,4,5,3,2,4,3
"Region3","holding","Hotels","January",12,2,5,3,5,13,414,436,18,22,427,27,454,5,2,4,2,3,4
"Region3","holding","Hotels","February",12,5,5,4,4,10,496,522,14,26,506,30,536,4,4,4,5,3,4
"Region3","holding","Hotels","March",13,3,4,5,4,11,420,445,15,25,431,29,460,5,3,5,2,5,5
"Region3","holding","Hotels","April",11,3,3,3,4,11,360,380,15,20,371,24,395,2,3,3,2,5,3
"Region3","holding","Hotels","May",11,5,3,2,5,13,452,473,18,21,465,26,491,3,4,5,2,3,4
"Region3","holding","Hotels","June",13,3,4,2,3,12,498,520,15,22,510,25,535,3,4,3,5,5,5
"Region3","holding","Hotels","July",12,3,3,3,4,12,498,519,16,21,510,25,535,3,2,2,2,3,5
"Region3","holding","Hotels","August",10,3,3,4,5,15,433,453,20,20,448,25,473,2,3,4,4,3,5
"Region3","holding","Hotels","September",11,2,2,4,4,12,426,445,16,19,438,23,461,3,4,2,5,3,4
"Region3","holding","Hotels","October",11,5,4,3,4,10,376,399,14,23,386,27,413,2,2,4,2,4,3
"Region3","holding","Hotels","November",12,2,2,4,3,11,430,450,14,20,441,23,464,4,4,5,2,3,3
"Region3","holding","Restaurants","January",12,3,3,4,2,14,420,442,16,22,434,24,458,4,2,4,3,5,5
"Region3","holding","Restaurants","February",11,3,3,2,2,14,434,453,16,19,448,21,469,4,3,2,5,3,3
"Region3","holding","Restaurants","March",10,2,4,3,2,12,454,473,14,19,466,21,487,4,3,3,2,5,5
"Region3","holding","Restaurants","April",11,4,4,5,5,15,367,391,20,24,382,29,411,3,4,3,4,3,5
"Region3","holding","Restaurants","May",10,4,4,4,4,13,337,359,17,22,350,26,376,3,3,3,4,3,4
"Region3","holding","Restaurants","June",11,5,3,2,2,14,378,399,16,21,392,23,415,3,3,3,3,3,5
"Region3","holding","Restaurants","July",12,3,4,5,2,13,334,358,15,24,347,26,373,3,2,4,5,3,5
"Region3","holding","Restaurants","August",12,2,3,4,4,13,349,370,17,21,362,25,387,3,2,3,2,3,3
"Region3","holding","Restaurants","September",12,4,4,3,5,12,384,407,17,23,396,28,424,2,5,3,4,4,4
"Region3","holding","Restaurants","October",13,2,3,4,3,12,396,418,15,22,408,25,433,4,5,2,4,3,5
"Region3","holding","Restaurants","November",12,3,4,3,4,12,487,509,16,22,499,26,525,4,3,4,4,4,4
"Region3","holding","Airline","January",11,3,2,2,3,12,372,390,15,18,384,21,405,5,3,4,5,2,4
"Region3","holding","Airline","February",10,3,3,4,2,13,467,487,15,20,480,22,502,3,2,4,4,4,3
"Region3","holding","Airline","March",11,4,3,2,3,14,324,344,17,20,338,23,361,3,4,4,3,4,4
"Region3","holding","Airline","April",13,3,4,3,4,12,498,521,16,23,510,27,537,2,5,4,3,5,5
"Region3","holding","Airline","May",12,4,4,3,2,14,396,419,16,23,410,25,435,3,4,4,5,3,2
"Region3","holding","Airline","June",11,3,2,4,5,10,491,511,15,20,501,25,526,4,2,2,4,2,5
"Region3","holding","Airline","July",12,3,3,2,2,12,479,499,14,20,491,22,513,3,4,3,2,4,4
"Region3","holding","Airline","August",10,4,2,3,4,12,455,474,16,19,467,23,490,3,4,2,3,4,4
"Region3","holding","Airline","September",13,2,2,4,4,11,386,407,15,21,397,25,422,5,4,5,4,3,4
"Region3","holding","Airline","October",13,3,4,3,2,14,321,344,16,23,335,25,360,5,3,5,2,4,2
"Region3","holding","Airline","November",10,3,3,4,3,12,436,456,15,20,448,23,471,3,4,3,3,3,4
"Region3","holding","Hardware Store","January",11,3,3,2,3,12,310,329,15,19,322,22,344,3,3,3,3,5,4
"Region3","holding","Hardware Store","February",11,4,4,4,4,14,430,453,18,23,444,27,471,2,4,3,2,5,3
"Region3","holding","Hardware Store","March",13,4,5,3,4,11,497,522,15,25,508,29,537,3,3,4,3,3,4
"Region3","holding","Hardware Store","April",10,2,3,2,4,13,486,503,17,17,499,21,520,2,4,3,2,2,3
"Region3","holding","Hardware Store","May",13,3,2,4,3,14,435,457,17,22,449,25,474,4,4,3,5,5,2
"Region3","holding","Hardware Store","June",10,4,4,5,3,14,408,431,17,23,422,26,448,5,5,5,3,3,5
"Region3","holding","Hardware Store","July",11,5,4,2,5,14,454,476,19,22,468,27,495,3,4,3,4,5,2
"Region3","holding","Hardware Store","August",13,4,4,4,2,12,448,473,14,25,460,27,487,4,5,4,2,5,3
"Region3","holding","Hardware Store","September",11,5,4,3,5,13,482,505,18,23,495,28,523,3,4,4,4,4,5
"Region3","holding","Hardware Store","October",11,4,3,2,2,12,422,442,14,20,434,22,456,4,4,3,4,2,4
"Region3","holding","Hardware Store","November",13,2,3,2,2,14,338,358,16,20,352,22,374,4,4,5,3,2,4
"Region3","holding","Computer Store","January",12,4,5,2,4,11,444,467,15,23,455,27,482,4,4,5,2,4,2
"Region3","holding","Computer Store","February",12,4,3,3,5,13,315,337,18,22,328,27,355,4,4,4,2,4,2
"Region3","holding","Computer Store","March",11,5,4,5,4,10,439,464,14,25,449,29,478,4,5,3,4,4,2
"Region3","holding","Computer Store","April",13,3,3,2,5,15,413,434,20,21,428,26,454,4,2,3,4,3,5
"Region3","holding","Computer Store","May",11,5,5,4,5,11,349,374,16,25,360,30,390,3,3,5,4,3,4
"Region3","holding","Computer Store","June",12,2,3,5,2,12,387,409,14,22,399,24,423,3,3,5,5,3,3
"Region3","holding","Computer Store","July",12,5,3,4,3,13,470,494,16,24,483,27,510,4,3,3,4,4,4
"Region3","holding","Computer Store","August",12,4,2,4,4,14,418,440,18,22,432,26,458,3,5,4,4,5,5
"Region3","holding","Computer Store","September",11,5,4,2,3,12,367,389,15,22,379,25,404,3,3,5,4,4,4
"Region3","holding","Computer Store","October",11,4,2,5,5,11,405,427,16,22,416,27,443,3,5,2,3,3,4
"Region3","holding","Computer Store","November",10,3,2,4,3,15,354,373,18,19,369,22,391,5,3,3,4,4,2
"Region3","holding","Gaming Zone","January",10,5,3,3,3,14,394,415,17,21,408,24,432,2,5,3,3,4,2
"Region3","holding","Gaming Zone","February",13,3,4,4,3,13,465,489,16,24,478,27,505,4,4,3,3,3,3
"Region3","holding","Gaming Zone","March",11,3,4,3,3,12,387,408,15,21,399,24,423,3,4,3,5,3,3
"Region3","holding","Gaming Zone","April",13,3,3,5,2,14,417,441,16,24,431,26,457,3,3,4,4,4,4
"Region3","holding","Gaming Zone","May",10,3,5,3,4,10,363,384,14,21,373,25,398,3,4,4,3,4,2
"Region3","holding","Gaming Zone","June",11,4,3,3,3,13,408,429,16,21,421,24,445,3,2,2,3,3,2
"Region3","holding","Gaming Zone","July",12,3,4,5,4,14,427,451,18,24,441,28,469,4,4,4,3,3,4
"Region3","holding","Gaming Zone","August",11,5,2,3,4,15,332,353,19,21,347,25,372,4,4,5,4,4,4
"Region3","holding","Gaming Zone","September",11,2,2,2,5,14,495,512,19,17,509,22,531,3,5,5,3,2,4
"Region3","holding","Gaming Zone","October",11,3,3,5,3,11,425,447,14,22,436,25,461,5,5,5,2,3,4
"Region3","holding","Gaming Zone","November",12,4,5,4,4,13,316,341,17,25,329,29,358,4,5,4,2,4,4
"Region3","holding","Super MArket","January",12,4,4,2,4,14,477,499,18,22,491,26,517,3,4,4,4,2,4
"Region3","holding","Super MArket","February",12,2,4,4,4,12,394,416,16,22,406,26,432,3,2,4,2,4,3
"Region3","holding","Super MArket","March",13,3,5,2,3,14,323,346,17,23,337,26,363,3,3,5,4,4,3
"Region3","holding","Super MArket","April",12,3,4,3,4,10,431,453,14,22,441,26,467,4,5,4,3,4,3
"Region3","holding","Super MArket","May",13,5,2,4,4,13,483,507,17,24,496,28,524,4,3,5,3,3,4
"Region3","holding","Super MArket","June",12,2,4,4,2,15,300,322,17,22,315,24,339,4,2,2,2,3,3
"Region3","holding","Super MArket","July",11,4,3,4,3,15,340,362,18,22,355,25,380,4,2,4,5,4,3
"Region3","holding","Super MArket","August",11,2,4,5,4,13,442,464,17,22,455,26,481,3,2,3,4,4,2
"Region3","holding","Super MArket","September",10,2,3,5,4,12,433,453,16,20,445,24,469,2,3,4,2,4,3
"Region3","holding","Super MArket","October",11,4,3,4,3,15,437,459,18,22,452,25,477,5,2,3,3,4,2
"Region3","holding","Super MArket","November",12,3,4,2,3,13,461,482,16,21,474,24,498,5,4,3,4,3,3
"Region3","holding","Fast Food Centre","January",10,4,4,2,4,12,421,441,16,20,433,24,457,3,2,3,3,2,5
"Region3","holding","Fast Food Centre","February",11,2,4,4,4,10,315,336,14,21,325,25,350,5,3,4,3,4,2
"Region3","holding","Fast Food Centre","March",11,4,5,4,4,13,444,468,17,24,457,28,485,2,2,2,3,2,3
"Region3","holding","Fast Food Centre","April",11,5,4,5,5,11,366,391,16,25,377,30,407,3,4,3,5,3,3
"Region3","holding","Fast Food Centre","May",11,2,5,5,4,13,397,420,17,23,410,27,437,5,4,5,5,4,3
"Region3","holding","Fast Food Centre","June",12,4,4,3,4,13,440,463,17,23,453,27,480,2,2,3,4,2,3
"Region3","holding","Fast Food Centre","July",11,3,3,4,3,12,381,402,15,21,393,24,417,4,3,3,4,3,2
"Region3","holding","Fast Food Centre","August",10,3,3,5,4,15,312,333,19,21,327,25,352,2,3,3,4,3,3
"Region3","holding","Fast Food Centre","September",13,3,3,5,4,14,455,479,18,24,469,28,497,5,5,5,2,4,3
"Region3","holding","Fast Food Centre","October",13,3,4,2,2,13,392,414,15,22,405,24,429,4,3,4,2,3,4
"Region3","holding","Fast Food Centre","November",10,2,2,3,2,13,453,470,15,17,466,19,485,4,3,2,4,4,4
"Region4","retail","Retail Store","January",11,4,2,4,4,15,413,434,19,21,428,25,453,3,4,2,5,3,3
"Region4","retail","Retail Store","February",10,5,2,3,4,14,302,322,18,20,316,24,340,2,3,4,3,3,4
"Region4","retail","Retail Store","March",12,5,5,3,4,13,498,523,17,25,511,29,540,2,4,3,3,3,3
"Region4","retail","Retail Store","April",10,3,4,3,4,14,350,370,18,20,364,24,388,3,4,4,2,4,3
"Region4","retail","Retail Store","May",13,5,3,3,4,14,423,447,18,24,437,28,465,3,4,5,3,4,5
"Region4","retail","Retail Store","June",11,5,3,2,4,15,327,348,19,21,342,25,367,2,4,5,3,3,4
"Region4","retail","Retail Store","July",10,4,3,3,2,10,386,406,12,20,396,22,418,3,5,2,3,5,4
"Region4","retail","Retail Store","August",10,3,4,5,3,11,324,346,14,22,335,25,360,2,5,5,4,3,3
"Region4","retail","Retail Store","September",13,4,3,4,4,15,369,393,19,24,384,28,412,2,3,3,3,4,3
"Region4","retail","Retail Store","October",10,4,2,4,3,14,351,371,17,20,365,23,388,5,4,5,4,2,5
"Region4","retail","Retail Store","November",12,3,4,4,4,14,386,409,18,23,400,27,427,3,4,5,3,5,5
"Region4","retail","Kirana Store","January",11,2,3,3,4,11,312,331,15,19,323,23,346,3,4,3,5,4,3
"Region4","retail","Kirana Store","February",10,3,4,3,2,12,365,385,14,20,377,22,399,5,5,3,4,4,4
"Region4","retail","Kirana Store","March",11,2,5,5,4,11,495,518,15,23,506,27,533,3,2,5,5,5,3
"Region4","retail","Kirana Store","April",10,4,3,4,4,12,472,493,16,21,484,25,509,5,4,5,2,5,5
"Region4","retail","Kirana Store","May",13,5,3,2,2,15,308,331,17,23,323,25,348,2,3,2,2,2,3
"Region4","retail","Kirana Store","June",10,4,4,4,5,13,319,341,18,22,332,27,359,3,3,3,5,4,3
"Region4","retail","Kirana Store","July",12,5,2,5,2,12,358,382,14,24,370,26,396,5,4,3,3,3,2
"Region4","retail","Kirana Store","August",11,3,3,3,4,12,351,371,16,20,363,24,387,5,5,5,3,3,4
"Region4","retail","Kirana Store","September",11,2,3,2,4,14,325,343,18,18,339,22,361,4,5,2,3,4,4
"Region4","retail","Kirana Store","October",11,5,5,3,3,13,347,371,16,24,360,27,387,5,4,2,2,3,3
"Region4","retail","Kirana Store","November",10,3,2,5,3,11,338,358,14,20,349,23,372,3,5,5,4,2,3
"Region4","retail","Hotels","January",12,2,3,3,3,15,391,411,18,20,406,23,429,3,4,2,4,3,3
"Region4","retail","Hotels","February",12,5,4,4,4,15,417,442,19,25,432,29,461,2,4,4,3,4,4
"Region4","retail","Hotels","March",13,4,2,4,4,13,405,428,17,23,418,27,445,2,2,3,3,4,4
"Region4","retail","Hotels","April",11,3,5,5,3,11,377,401,14,24,388,27,415,3,3,4,3,2,4
"Region4","retail","Hotels","May",12,3,3,3,3,14,402,423,17,21,416,24,440,2,2,5,4,5,2
"Region4","retail","Hotels","June",12,4,4,4,4,13,499,523,17,24,512,28,540,4,3,5,4,4,4
"Region4","retail","Hotels","July",10,4,2,5,3,15,308,329,18,21,323,24,347,4,4,2,4,5,3
"Region4","retail","Hotels","August",12,2,3,3,3,11,340,360,14,20,351,23,374,4,3,4,4,3,2
"Region4","retail","Hotels","September",11,4,4,2,5,11,429,450,16,21,440,26,466,5,3,3,4,4,5
"Region4","retail","Hotels","October",10,2,4,5,4,15,301,322,19,21,316,25,341,3,4,3,4,3,3
"Region4","retail","Hotels","November",11,2,4,3,5,11,448,468,16,20,459,25,484,3,5,4,4,4,2
"Region4","retail","Restaurants","January",12,4,3,3,4,12,420,442,16,22,432,26,458,4,2,2,4,3,2
"Region4","retail","Restaurants","February",10,4,2,5,4,13,421,442,17,21,434,25,459,4,3,5,2,5,4
"Region4","retail","Restaurants","March",11,3,4,3,5,10,363,384,15,21,373,26,399,2,3,2,5,5,5
"Region4","retail","Restaurants","April",12,4,4,4,5,12,464,488,17,24,476,29,505,2,3,2,3,4,4
"Region4","retail","Restaurants","May",11,4,3,5,5,10,301,324,15,23,311,28,339,3,5,3,5,2,2
"Region4","retail","Restaurants","June",11,4,3,3,4,14,427,448,18,21,441,25,466,3,3,5,4,4,4
"Region4","retail","Restaurants","July",13,3,2,4,4,10,417,439,14,22,427,26,453,5,4,5,3,2,4
"Region4","retail","Restaurants","August",13,4,4,2,2,13,477,500,15,23,490,25,515,5,2,4,4,2,5
"Region4","retail","Restaurants","September",11,2,4,4,3,13,442,463,16,21,455,24,479,4,2,5,4,3,5
"Region4","retail","Restaurants","October",12,5,3,2,4,13,444,466,17,22,457,26,483,3,4,4,4,4,4
"Region4","retail","Restaurants","November",12,4,3,2,4,14,466,487,18,21,480,25,505,4,4,3,3,4,4
"Region4","retail","Airline","January",11,4,3,4,4,10,477,499,14,22,487,26,513,4,5,5,5,3,5
"Region4","retail","Airline","February",12,3,5,5,3,14,454,479,17,25,468,28,496,3,3,2,3,5,3
"Region4","retail","Airline","March",13,4,3,3,5,11,451,474,16,23,462,28,490,4,4,5,5,3,3
"Region4","retail","Airline","April",10,4,2,4,5,11,332,352,16,20,343,25,368,3,5,2,5,2,4
"Region4","retail","Airline","May",11,3,2,2,4,11,331,349,15,18,342,22,364,4,4,2,4,4,5
"Region4","retail","Airline","June",11,4,2,3,3,12,404,424,15,20,416,23,439,4,2,4,4,5,5
"Region4","retail","Airline","July",10,2,2,3,5,11,378,395,16,17,389,22,411,4,4,3,3,5,2
"Region4","retail","Airline","August",11,2,3,3,3,11,358,377,14,19,369,22,391,4,4,5,2,4,3
"Region4","retail","Airline","September",12,4,5,4,4,11,418,443,15,25,429,29,458,3,4,3,3,4,4
"Region4","retail","Airline","October",12,2,4,4,3,15,433,455,18,22,448,25,473,5,2,3,2,4,3
"Region4","retail","Airline","November",10,3,4,4,5,13,361,382,18,21,374,26,400,4,4,3,3,3,3
"Region4","retail","Hardware Store","January",12,4,3,3,3,12,454,476,15,22,466,25,491,2,5,5,3,5,4
"Region4","retail","Hardware Store","February",12,2,4,3,3,12,366,387,15,21,378,24,402,5,3,3,3,2,5
"Region4","retail","Hardware Store","March",10,3,4,2,4,10,374,393,14,19,384,23,407,3,4,4,2,5,4
"Region4","retail","Hardware Store","April",11,5,4,4,3,12,495,519,15,24,507,27,534,4,5,5,3,2,3
"Region4","retail","Hardware Store","May",12,4,4,3,4,14,435,458,18,23,449,27,476,4,2,4,4,3,5
"Region4","retail","Hardware Store","June",12,4,4,2,3,11,416,438,14,22,427,25,452,2,4,5,2,3,4
"Region4","retail","Hardware Store","July",10,4,4,3,4,14,465,486,18,21,479,25,504,3,5,4,3,4,2
"Region4","retail","Hardware Store","August",13,5,3,4,3,11,381,406,14,25,392,28,420,5,4,3,3,4,3
"Region4","retail","Hardware Store","September",12,4,4,2,5,14,383,405,19,22,397,27,424,5,4,4,3,2,2
"Region4","retail","Hardware Store","October",10,2,4,5,5,11,448,469,16,21,459,26,485,4,5,5,3,3,4
"Region4","retail","Hardware Store","November",12,4,3,4,5,11,490,513,16,23,501,28,529,3,5,4,4,4,3
"Region4","retail","Computer Store","January",11,2,4,3,3,11,340,360,14,20,351,23,374,2,3,4,5,4,4
"Region4","retail","Computer Store","February",12,4,4,5,2,11,492,517,13,25,503,27,530,3,4,5,5,5,3
"Region4","retail","Computer Store","March",12,3,4,5,2,12,353,377,14,24,365,26,391,3,5,4,2,2,2
"Region4","retail","Computer Store","April",10,3,4,3,3,14,441,461,17,20,455,23,478,2,3,3,2,3,5
"Region4","retail","Computer Store","May",12,4,3,3,3,12,308,330,15,22,320,25,345,3,3,5,2,4,4
"Region4","retail","Computer Store","June",11,2,3,2,2,14,434,452,16,18,448,20,468,4,4,5,4,5,2
"Region4","retail","Computer Store","July",10,2,3,5,2,12,460,480,14,20,472,22,494,2,2,5,4,4,5
"Region4","retail","Computer Store","August",11,5,5,3,4,15,377,401,19,24,392,28,420,3,5,2,5,3,3
"Region4","retail","Computer Store","September",13,5,2,4,5,12,408,432,17,24,420,29,449,3,2,3,4,4,3
"Region4","retail","Computer Store","October",12,4,4,4,4,13,434,458,17,24,447,28,475,2,4,4,4,5,5
"Region4","retail","Computer Store","November",11,5,2,3,4,14,369,390,18,21,383,25,408,2,2,2,5,3,4
"Region4","retail","Gaming Zone","January",13,5,2,2,5,11,452,474,16,22,463,27,490,5,4,2,3,3,3
"Region4","retail","Gaming Zone","February",11,3,4,4,4,12,353,375,16,22,365,26,391,5,3,4,5,3,4
"Region4","retail","Gaming Zone","March",12,4,4,3,4,12,393,416,16,23,405,27,432,3,3,4,5,5,3
"Region4","retail","Gaming Zone","April",12,2,2,3,2,12,325,344,14,19,337,21,358,3,4,2,4,2,3
"Region4","retail","Gaming Zone","May",12,4,4,3,2,13,463,486,15,23,476,25,501,2,5,4,5,5,4
"Region4","retail","Gaming Zone","June",12,4,2,4,2,13,335,357,15,22,348,24,372,4,3,4,2,3,2
"Region4","retail","Gaming Zone","July",10,2,3,3,5,10,425,443,15,18,435,23,458,4,5,2,5,3,3
"Region4","retail","Gaming Zone","August",12,2,4,4,3,13,375,397,16,22,388,25,413,3,2,3,4,4,4
"Region4","retail","Gaming Zone","September",11,4,4,5,4,11,308,332,15,24,319,28,347,3,3,3,5,5,3
"Region4","retail","Gaming Zone","October",12,5,4,5,5,10,461,487,15,26,471,31,502,3,3,4,2,2,2
"Region4","retail","Gaming Zone","November",12,3,3,3,5,10,405,426,15,21,415,26,441,2,4,4,3,4,4
"Region4","retail","Super MArket","January",10,4,2,3,5,10,470,489,15,19,480,24,504,2,2,5,3,3,4
"Region4","retail","Super MArket","February",11,4,3,4,4,11,427,449,15,22,438,26,464,5,3,3,2,4,3
"Region4","retail","Super MArket","March",13,3,5,3,3,12,369,393,15,24,381,27,408,3,3,5,3,5,2
"Region4","retail","Super MArket","April",10,2,3,4,3,13,400,419,16,19,413,22,435,3,4,4,3,4,4
"Region4","retail","Super MArket","May",12,3,4,2,3,12,439,460,15,21,451,24,475,5,4,4,3,3,2
"Region4","retail","Super MArket","June",11,2,3,2,4,13,498,516,17,18,511,22,533,3,3,4,4,4,4
"Region4","retail","Super MArket","July",11,3,3,4,4,11,429,450,15,21,440,25,465,4,4,5,4,2,3
"Region4","retail","Super MArket","August",11,2,2,4,3,11,441,460,14,19,452,22,474,3,5,4,3,4,3
"Region4","retail","Super MArket","September",12,3,4,4,5,12,344,367,17,23,356,28,384,2,2,2,4,4,4
"Region4","retail","Super MArket","October",11,3,4,3,3,11,303,324,14,21,314,24,338,5,2,2,4,3,2
"Region4","retail","Super MArket","November",12,4,4,3,3,14,419,442,17,23,433,26,459,5,5,4,3,5,2
"Region4","retail","Fast Food Centre","January",10,3,5,3,4,11,355,376,15,21,366,25,391,2,4,4,4,3,4
"Region4","retail","Fast Food Centre","February",12,2,2,4,2,12,478,498,14,20,490,22,512,2,5,2,4,5,5
"Region4","retail","Fast Food Centre","March",12,3,3,3,5,10,464,485,15,21,474,26,500,4,2,2,3,4,5
"Region4","retail","Fast Food Centre","April",10,4,2,3,3,11,337,356,14,19,348,22,370,3,4,2,5,3,5
"Region4","retail","Fast Food Centre","May",10,3,3,2,2,10,432,450,12,18,442,20,462,5,3,3,3,5,3
"Region4","retail","Fast Food Centre","June",11,2,2,4,3,14,308,327,17,19,322,22,344,5,5,3,2,5,5
"Region4","retail","Fast Food Centre","July",10,5,3,3,2,10,477,498,12,21,487,23,510,4,4,4,3,2,5
"Region4","retail","Fast Food Centre","August",12,3,4,3,5,13,487,509,18,22,500,27,527,4,3,4,4,4,5
"Region4","retail","Fast Food Centre","September",10,4,5,2,4,12,354,375,16,21,366,25,391,3,5,4,4,3,4
"Region4","retail","Fast Food Centre","October",11,4,5,2,5,13,436,458,18,22,449,27,476,3,2,3,2,4,5
"Region4","retail","Fast Food Centre","November",13,4,4,4,3,13,497,522,16,25,510,28,538,2,5,5,4,4,3
"Region4","holding","Retail Store","January",13,3,4,5,4,14,465,490,18,25,479,29,508,3,4,2,3,5,4
"Region4","holding","Retail Store","February",11,5,2,4,5,11,470,492,16,22,481,27,508,3,2,4,4,4,2
"Region4","holding","Retail Store","March",12,4,4,4,5,11,496,520,16,24,507,29,536,2,4,4,3,2,3
"Region4","holding","Retail Store","April",11,3,4,4,4,13,408,430,17,22,421,26,447,2,4,3,3,5,3
"Region4","holding","Retail Store","May",12,5,3,5,3,11,368,393,14,25,379,28,407,3,5,5,3,3,3
"Region4","holding","Retail Store","June",10,3,5,4,3,10,462,484,13,22,472,25,497,4,4,5,5,4,4
"Region4","holding","Retail Store","July",13,4,4,2,2,13,377,400,15,23,390,25,415,4,4,4,3,3,3
"Region4","holding","Retail Store","August",11,3,3,5,2,11,349,371,13,22,360,24,384,2,5,3,3,4,5
"Region4","holding","Retail Store","September",11,2,5,2,3,15,458,478,18,20,473,23,496,3,2,4,2,3,4
"Region4","holding","Retail Store","October",12,3,4,3,4,13,394,416,17,22,407,26,433,4,3,3,4,4,3
"Region4","holding","Retail Store","November",13,4,3,5,4,13,428,453,17,25,441,29,470,2,4,4,4,4,4
"Region4","holding","Kirana Store","January",11,3,5,2,4,15,371,392,19,21,386,25,411,3,3,3,3,5,2
"Region4","holding","Kirana Store","February",10,4,4,5,3,13,403,426,16,23,416,26,442,3,3,2,3,2,3
"Region4","holding","Kirana Store","March",11,3,5,3,2,12,474,496,14,22,486,24,510,5,3,2,2,2,5
"Region4","holding","Kirana Store","April",13,4,2,4,4,14,354,377,18,23,368,27,395,2,2,4,4,3,3
"Region4","holding","Kirana Store","May",13,4,3,3,4,14,396,419,18,23,410,27,437,5,2,3,2,4,3
"Region4","holding","Kirana Store","June",11,4,4,3,4,13,490,512,17,22,503,26,529,5,4,3,2,2,5
"Region4","holding","Kirana Store","July",13,4,4,5,3,12,321,347,15,26,333,29,362,3,4,3,4,3,5
"Region4","holding","Kirana Store","August",12,4,3,4,4,11,418,441,15,23,429,27,456,4,4,4,4,2,4
"Region4","holding","Kirana Store","September",12,4,3,4,5,14,402,425,19,23,416,28,444,2,3,4,2,5,3
"Region4","holding","Kirana Store","October",10,5,5,3,2,12,404,427,14,23,416,25,441,3,5,3,2,2,4
"Region4","holding","Kirana Store","November",10,2,3,2,5,12,466,483,17,17,478,22,500,3,4,3,2,3,5
"Region4","holding","Hotels","January",13,4,3,4,5,10,338,362,15,24,348,29,377,2,5,2,2,4,3
"Region4","holding","Hotels","February",13,3,2,4,4,11,385,407,15,22,396,26,422,5,2,2,4,3,5
"Region4","holding","Hotels","March",11,5,3,3,4,15,305,327,19,22,320,26,346,4,3,2,3,5,4
"Region4","holding","Hotels","April",13,4,3,5,3,14,352,377,17,25,366,28,394,4,5,2,2,4,3
"Region4","holding","Hotels","May",12,2,5,3,4,11,476,498,15,22,487,26,513,4,5,3,4,2,4
"Region4","holding","Hotels","June",11,4,2,5,2,14,327,349,16,22,341,24,365,4,4,4,2,3,4
"Region4","holding","Hotels","July",11,5,4,5,3,11,312,337,14,25,323,28,351,5,2,5,3,4,4
"Region4","holding","Hotels","August",11,4,3,2,3,12,309,329,15,20,321,23,344,4,4,4,3,3,3
"Region4","holding","Hotels","September",12,4,5,4,3,10,337,362,13,25,347,28,375,2,3,4,4,2,4
"Region4","holding","Hotels","October",10,5,5,4,4,15,451,475,19,24,466,28,494,3,2,4,3,3,4
"Region4","holding","Hotels","November",12,5,4,5,3,15,397,423,18,26,412,29,441,4,4,4,4,3,3
"Region4","holding","Restaurants","January",11,2,2,2,5,10,472,489,15,17,482,22,504,5,5,4,3,5,4
"Region4","holding","Restaurants","February",12,4,5,3,2,15,316,340,17,24,331,26,357,2,3,5,4,4,4
"Region4","holding","Restaurants","March",11,4,5,3,3,13,437,460,16,23,450,26,476,5,4,3,2,3,3
"Region4","holding","Restaurants","April",12,2,2,3,3,12,402,421,15,19,414,22,436,4,4,4,5,4,4
"Region4","holding","Restaurants","May",12,4,3,4,3,12,402,425,15,23,414,26,440,3,5,5,5,4,2
"Region4","holding","Restaurants","June",11,4,3,2,3,12,454,474,15,20,466,23,489,3,2,3,3,3,5
"Region4","holding","Restaurants","July",11,4,2,2,4,12,479,498,16,19,491,23,514,4,4,4,3,4,4
"Region4","holding","Restaurants","August",11,3,4,2,3,13,492,512,16,20,505,23,528,5,3,4,4,2,3
"Region4","holding","Restaurants","September",13,2,3,5,5,14,355,378,19,23,369,28,397,3,4,4,4,3,3
"Region4","holding","Restaurants","October",11,4,4,4,5,13,476,499,18,23,489,28,517,2,5,4,4,3,2
"Region4","holding","Restaurants","November",12,2,4,5,4,11,437,460,15,23,448,27,475,5,3,3,5,2,4
"Region4","holding","Airline","January",11,4,4,4,3,12,356,379,15,23,368,26,394,3,3,3,2,4,3
"Region4","holding","Airline","February",12,5,3,5,3,10,372,397,13,25,382,28,410,5,2,4,2,2,2
"Region4","holding","Airline","March",12,3,2,3,4,14,368,388,18,20,382,24,406,2,2,3,3,3,4
"Region4","holding","Airline","April",11,4,2,5,2,13,411,433,15,22,424,24,448,4,2,4,2,4,4
"Region4","holding","Airline","May",11,4,3,4,4,14,374,396,18,22,388,26,414,3,4,4,4,2,2
"Region4","holding","Airline","June",12,4,4,2,3,11,403,425,14,22,414,25,439,3,3,5,4,4,4
"Region4","holding","Airline","July",12,5,3,4,3,10,469,493,13,24,479,27,506,5,4,3,5,2,5
"Region4","holding","Airline","August",11,4,5,3,4,13,479,502,17,23,492,27,519,3,3,4,3,3,4
"Region4","holding","Airline","September",13,4,3,3,3,11,376,399,14,23,387,26,413,4,5,4,3,4,5
"Region4","holding","Airline","October",12,4,5,3,3,12,331,355,15,24,343,27,370,3,4,4,4,3,2
"Region4","holding","Airline","November",13,4,5,5,4,12,335,362,16,27,347,31,378,3,4,4,5,3,2
"Region4","holding","Hardware Store","January",12,2,3,5,5,10,499,521,15,22,509,27,536,3,2,5,5,5,3
"Region4","holding","Hardware Store","February",12,4,4,2,3,12,344,366,15,22,356,25,381,3,4,4,3,4,4
"Region4","holding","Hardware Store","March",11,3,5,2,3,12,309,330,15,21,321,24,345,3,4,4,4,2,2
"Region4","holding","Hardware Store","April",10,4,5,3,3,11,370,392,14,22,381,25,406,3,4,4,4,5,3
"Region4","holding","Hardware Store","May",12,3,4,4,3,12,340,363,15,23,352,26,378,4,4,4,2,4,4
"Region4","holding","Hardware Store","June",13,2,2,3,4,11,401,421,15,20,412,24,436,2,4,4,3,4,5
"Region4","holding","Hardware Store","July",12,4,2,4,3,13,368,390,16,22,381,25,406,2,2,3,4,2,3
"Region4","holding","Hardware Store","August",12,4,4,4,5,12,421,445,17,24,433,29,462,4,2,5,2,3,3
"Region4","holding","Hardware Store","September",12,2,5,4,3,11,357,380,14,23,368,26,394,2,3,3,3,4,2
"Region4","holding","Hardware Store","October",12,4,4,2,3,13,342,364,16,22,355,25,380,4,4,4,5,4,3
"Region4","holding","Hardware Store","November",13,2,5,4,4,12,437,461,16,24,449,28,477,4,4,2,3,3,4
"Region4","holding","Computer Store","January",13,3,4,3,3,11,424,447,14,23,435,26,461,2,5,4,4,5,3
"Region4","holding","Computer Store","February",10,2,2,4,5,12,427,445,17,18,439,23,462,4,5,3,2,5,3
"Region4","holding","Computer Store","March",11,3,5,3,5,11,390,412,16,22,401,27,428,4,4,3,4,3,4
"Region4","holding","Computer Store","April",13,3,4,4,2,15,427,451,17,24,442,26,468,3,2,3,4,5,4
"Region4","holding","Computer Store","May",12,5,3,5,2,13,344,369,15,25,357,27,384,4,4,5,5,5,4
"Region4","holding","Computer Store","June",11,4,3,3,2,14,336,357,16,21,350,23,373,3,4,2,2,3,4
"Region4","holding","Computer Store","July",12,4,2,4,4,14,444,466,18,22,458,26,484,3,3,4,3,4,5
"Region4","holding","Computer Store","August",13,3,5,2,4,12,398,421,16,23,410,27,437,3,4,3,3,2,4
"Region4","holding","Computer Store","September",12,4,4,3,3,11,320,343,14,23,331,26,357,5,2,2,5,4,4
"Region4","holding","Computer Store","October",13,2,4,3,4,14,470,492,18,22,484,26,510,5,4,5,4,4,5
"Region4","holding","Computer Store","November",12,5,3,3,3,14,401,424,17,23,415,26,441,2,3,5,5,3,5
"Region4","holding","Gaming Zone","January",10,3,2,2,3,12,321,338,15,17,333,20,353,4,4,4,3,5,4
"Region4","holding","Gaming Zone","February",13,3,3,4,4,13,437,460,17,23,450,27,477,3,3,5,4,4,4
"Region4","holding","Gaming Zone","March",12,4,3,3,3,12,468,490,15,22,480,25,505,5,2,3,3,4,4
"Region4","holding","Gaming Zone","April",13,3,5,4,4,12,301,326,16,25,313,29,342,3,4,3,3,4,2
"Region4","holding","Gaming Zone","May",11,5,2,3,4,13,413,434,17,21,426,25,451,4,4,5,4,4,3
"Region4","holding","Gaming Zone","June",12,3,3,4,3,11,326,348,14,22,337,25,362,3,3,2,4,5,3
"Region4","holding","Gaming Zone","July",12,2,5,4,4,10,418,441,14,23,428,27,455,4,4,3,3,4,3
"Region4","holding","Gaming Zone","August",11,3,4,3,5,14,392,413,19,21,406,26,432,5,4,3,5,4,4
"Region4","holding","Gaming Zone","September",13,3,4,4,4,12,463,487,16,24,475,28,503,3,5,4,4,2,5
"Region4","holding","Gaming Zone","October",12,3,3,3,5,14,377,398,19,21,391,26,417,3,5,4,2,3,5
"Region4","holding","Gaming Zone","November",13,2,2,4,3,15,375,396,18,21,390,24,414,3,3,3,3,3,4
"Region4","holding","Super MArket","January",12,2,4,3,4,11,379,400,15,21,390,25,415,4,4,4,4,2,3
"Region4","holding","Super MArket","February",13,2,2,5,2,13,440,462,15,22,453,24,477,4,4,4,4,4,4
"Region4","holding","Super MArket","March",11,2,2,5,3,12,460,480,15,20,472,23,495,3,3,4,2,4,4
"Region4","holding","Super MArket","April",13,4,2,4,3,14,346,369,17,23,360,26,386,4,3,2,5,2,5
"Region4","holding","Super MArket","May",12,2,4,3,2,11,345,366,13,21,356,23,379,4,4,4,3,4,4
"Region4","holding","Super MArket","June",12,3,5,4,4,14,334,358,18,24,348,28,376,3,4,2,2,4,3
"Region4","holding","Super MArket","July",11,5,4,4,3,11,394,418,14,24,405,27,432,4,3,3,2,2,3
"Region4","holding","Super MArket","August",11,2,3,5,4,10,491,512,14,21,501,25,526,4,4,4,4,5,3
"Region4","holding","Super MArket","September",11,2,4,4,4,14,494,515,18,21,508,25,533,3,5,3,3,3,4
"Region4","holding","Super MArket","October",12,2,3,4,3,12,483,504,15,21,495,24,519,2,5,4,5,3,3
"Region4","holding","Super MArket","November",12,4,5,3,4,14,493,517,18,24,507,28,535,5,5,3,3,4,4
"Region4","holding","Fast Food Centre","January",11,2,4,5,4,15,365,387,19,22,380,26,406,5,4,4,4,3,3
"Region4","holding","Fast Food Centre","February",10,3,4,2,3,13,455,474,16,19,468,22,490,4,3,5,2,2,2
"Region4","holding","Fast Food Centre","March",12,3,3,4,4,15,360,382,19,22,375,26,401,4,4,2,3,3,4
"Region4","holding","Fast Food Centre","April",12,2,4,4,2,12,353,375,14,22,365,24,389,4,4,5,4,3,2
"Region4","holding","Fast Food Centre","May",11,2,5,3,3,10,403,424,13,21,413,24,437,4,3,3,2,3,2
"Region4","holding","Fast Food Centre","June",13,5,3,5,4,13,383,409,17,26,396,30,426,4,4,5,2,3,3
"Region4","holding","Fast Food Centre","July",12,4,4,5,5,10,366,391,15,25,376,30,406,3,3,4,5,4,4
"Region4","holding","Fast Food Centre","August",11,4,2,5,4,10,440,462,14,22,450,26,476,4,5,3,5,4,3
"Region4","holding","Fast Food Centre","September",11,3,3,5,3,15,353,375,18,22,368,25,393,4,3,4,4,5,2
"Region4","holding","Fast Food Centre","October",11,2,3,3,3,11,487,506,14,19,498,22,520,2,4,4,4,4,2
"Region4","holding","Fast Food Centre","November",12,2,5,4,5,15,338,361,20,23,353,28,381,3,3,4,5,4,2
"Region5","retail","Retail Store","January",11,5,3,3,5,14,459,481,19,22,473,27,500,3,3,3,2,3,3
"Region5","retail","Retail Store","February",12,5,3,2,3,12,464,486,15,22,476,25,501,3,3,4,4,4,5
"Region5","retail","Retail Store","March",12,4,4,3,4,14,404,427,18,23,418,27,445,4,4,4,3,2,5
"Region5","retail","Retail Store","April",10,3,3,4,3,14,436,456,17,20,450,23,473,4,2,3,3,3,5
"Region5","retail","Retail Store","May",10,4,5,4,3,15,372,395,18,23,387,26,413,4,4,2,3,2,3
"Region5","retail","Retail Store","June",11,2,5,3,3,13,406,427,16,21,419,24,443,5,5,5,3,5,4
"Region5","retail","Retail Store","July",13,3,4,3,3,10,497,520,13,23,507,26,533,3,4,3,5,5,4
"Region5","retail","Retail Store","August",10,5,3,4,3,12,305,327,15,22,317,25,342,4,5,4,4,3,3
"Region5","retail","Retail Store","September",11,5,3,3,4,12,453,475,16,22,465,26,491,3,2,2,2,2,3
"Region5","retail","Retail Store","October",10,4,5,3,3,15,341,363,18,22,356,25,381,3,5,4,3,4,3
"Region5","retail","Retail Store","November",10,4,2,4,4,11,471,491,15,20,482,24,506,4,4,3,4,4,4
"Region5","retail","Kirana Store","January",12,5,5,3,4,13,402,427,17,25,415,29,444,2,5,5,2,5,2
"Region5","retail","Kirana Store","February",10,4,4,4,3,13,451,473,16,22,464,25,489,4,3,3,4,2,4
"Region5","retail","Kirana Store","March",12,4,3,5,2,13,307,331,15,24,320,26,346,3,3,3,4,2,3
"Region5","retail","Kirana Store","April",12,4,4,5,4,14,474,499,18,25,488,29,517,4,3,3,3,5,3
"Region5","retail","Kirana Store","May",13,3,3,4,2,12,490,513,14,23,502,25,527,3,4,2,4,4,2
"Region5","retail","Kirana Store","June",13,3,4,4,3,15,343,367,18,24,358,27,385,4,3,3,4,2,3
"Region5","retail","Kirana Store","July",11,4,3,4,3,13,466,488,16,22,479,25,504,3,3,4,2,3,5
"Region5","retail","Kirana Store","August",11,3,2,5,3,12,482,503,15,21,494,24,518,2,4,5,5,4,3
"Region5","retail","Kirana Store","September",13,2,2,5,4,14,433,455,18,22,447,26,473,3,3,3,2,4,5
"Region5","retail","Kirana Store","October",13,3,2,4,2,10,345,367,12,22,355,24,379,4,3,3,4,4,3
"Region5","retail","Kirana Store","November",12,5,4,4,4,14,337,362,18,25,351,29,380,3,4,2,4,2,5
"Region5","retail","Hotels","January",12,5,4,5,3,15,384,410,18,26,399,29,428,4,5,2,4,3,5
"Region5","retail","Hotels","February",11,5,4,4,3,14,313,337,17,24,327,27,354,2,4,5,3,5,4
"Region5","retail","Hotels","March",12,3,2,5,5,12,364,386,17,22,376,27,403,3,3,4,3,3,4
"Region5","retail","Hotels","April",12,3,2,5,4,14,463,485,18,22,477,26,503,4,5,5,3,2,3
"Region5","retail","Hotels","May",10,3,3,3,5,14,452,471,19,19,466,24,490,2,2,3,3,3,4
"Region5","retail","Hotels","June",11,4,2,3,3,12,302,322,15,20,314,23,337,4,3,5,2,5,4
"Region5","retail","Hotels","July",10,3,5,3,3,12,434,455,15,21,446,24,470,4,5,4,3,4,2
"Region5","retail","Hotels","August",12,3,4,3,2,13,473,495,15,22,486,24,510,3,4,3,5,4,5
"Region5","retail","Hotels","September",10,3,5,5,3,13,331,354,16,23,344,26,370,3,2,3,2,3,5
"Region5","retail","Hotels","October",12,4,3,2,5,12,317,338,17,21,329,26,355,4,3,4,2,5,3
"Region5","retail","Hotels","November",13,3,4,4,4,11,401,425,15,24,412,28,440,5,3,4,4,3,3
"Region5","retail","Restaurants","January",12,5,4,4,3,10,376,401,13,25,386,28,414,4,3,4,3,2,3
"Region5","retail","Restaurants","February",10,3,2,4,4,11,409,428,15,19,420,23,443,4,4,3,4,5,3
"Region5","retail","Restaurants","March",11,5,5,4,4,14,471,496,18,25,485,29,514,2,3,3,4,4,4
"Region5","retail","Restaurants","April",11,3,3,5,4,14,453,475,18,22,467,26,493,5,3,3,3,3,4
"Region5","retail","Restaurants","May",12,5,3,4,4,11,420,444,15,24,431,28,459,3,4,3,3,5,3
"Region5","retail","Restaurants","June",13,4,3,3,2,10,441,464,12,23,451,25,476,5,4,5,4,4,4
"Region5","retail","Restaurants","July",12,4,2,4,3,13,477,499,16,22,490,25,515,3,4,3,5,3,3
"Region5","retail","Restaurants","August",11,2,2,5,4,13,363,383,17,20,376,24,400,3,5,3,5,2,2
"Region5","retail","Restaurants","September",10,3,4,2,4,13,445,464,17,19,458,23,481,4,3,4,5,2,4
"Region5","retail","Restaurants","October",13,5,3,3,3,13,494,518,16,24,507,27,534,4,5,3,2,4,3
"Region5","retail","Restaurants","November",10,3,3,4,2,15,421,441,17,20,436,22,458,2,5,3,4,4,2
"Region5","retail","Airline","January",13,4,3,3,4,13,497,520,17,23,510,27,537,5,4,2,2,4,5
"Region5","retail","Airline","February",12,3,2,4,4,13,303,324,17,21,316,25,341,3,3,4,2,4,2
"Region5","retail","Airline","March",11,4,5,3,3,13,380,403,16,23,393,26,419,5,4,4,3,3,2
"Region5","retail","Airline","April",10,3,4,3,5,12,400,420,17,20,412,25,437,5,3,2,3,2,4
"Region5","retail","Airline","May",12,2,3,3,4,12,351,371,16,20,363,24,387,4,3,3,5,2,4
"Region5","retail","Airline","June",13,3,4,3,2,11,467,490,13,23,478,25,503,2,5,4,5,3,2
"Region5","retail","Airline","July",13,3,2,4,3,14,347,369,17,22,361,25,386,3,4,4,3,3,2
"Region5","retail","Airline","August",12,5,3,5,3,10,339,364,13,25,349,28,377,3,3,4,5,4,3
"Region5","retail","Airline","September",11,3,2,4,3,13,326,346,16,20,339,23,362,3,2,5,5,2,4
"Region5","retail","Airline","October",11,5,4,2,4,13,418,440,17,22,431,26,457,2,2,4,4,3,4
"Region5","retail","Airline","November",11,5,4,2,2,15,360,382,17,22,375,24,399,4,3,2,3,4,4
"Region5","retail","Hardware Store","January",11,2,4,4,2,14,358,379,16,21,372,23,395,4,5,4,4,5,4
"Region5","retail","Hardware Store","February",10,4,4,3,2,15,308,329,17,21,323,23,346,2,2,3,3,3,5
"Region5","retail","Hardware Store","March",13,3,4,5,2,10,367,392,12,25,377,27,404,5,4,4,5,5,4
"Region5","retail","Hardware Store","April",10,2,5,4,5,11,337,358,16,21,348,26,374,5,4,3,2,4,3
"Region5","retail","Hardware Store","May",12,2,4,2,5,15,307,327,20,20,322,25,347,3,4,3,5,2,4
"Region5","retail","Hardware Store","June",12,4,4,3,3,12,329,352,15,23,341,26,367,3,2,3,4,4,3
"Region5","retail","Hardware Store","July",11,3,5,3,4,15,460,482,19,22,475,26,501,3,5,2,3,4,3
"Region5","retail","Hardware Store","August",13,3,4,4,2,13,365,389,15,24,378,26,404,3,5,3,4,4,2
"Region5","retail","Hardware Store","September",10,4,4,5,3,13,488,511,16,23,501,26,527,2,4,4,4,3,4
"Region5","retail","Hardware Store","October",12,3,4,4,3,15,461,484,18,23,476,26,502,2,3,3,3,5,3
"Region5","retail","Hardware Store","November",11,5,3,2,4,10,338,359,14,21,348,25,373,4,5,5,2,2,4
"Region5","retail","Computer Store","January",11,5,3,5,4,15,369,393,19,24,384,28,412,2,4,2,2,2,4
"Region5","retail","Computer Store","February",13,3,3,2,4,11,338,359,15,21,349,25,374,2,3,4,3,2,3
"Region5","retail","Computer Store","March",12,2,2,2,3,10,427,445,13,18,437,21,458,4,4,4,2,4,3
"Region5","retail","Computer Store","April",11,3,4,3,2,10,399,420,12,21,409,23,432,4,4,4,5,3,5
"Region5","retail","Computer Store","May",10,2,3,3,4,10,340,358,14,18,350,22,372,4,3,4,4,4,2
"Region5","retail","Computer Store","June",11,5,3,3,3,11,350,372,14,22,361,25,386,4,4,4,3,4,4
"Region5","retail","Computer Store","July",11,4,3,3,3,14,404,425,17,21,418,24,442,2,2,2,2,5,4
"Region5","retail","Computer Store","August",11,4,3,5,3,14,444,467,17,23,458,26,484,3,3,4,4,2,4
"Region5","retail","Computer Store","September",10,3,3,3,5,14,315,334,19,19,329,24,353,2,2,3,5,4,2
"Region5","retail","Computer Store","October",12,4,4,2,5,11,483,505,16,22,494,27,521,3,3,5,4,3,5
"Region5","retail","Computer Store","November",11,4,3,3,2,14,330,351,16,21,344,23,367,5,4,5,3,3,3
"Region5","retail","Gaming Zone","January",12,5,3,4,3,13,441,465,16,24,454,27,481,4,5,5,5,3,4
"Region5","retail","Gaming Zone","February",11,5,4,5,4,11,343,368,15,25,354,29,383,3,5,2,2,4,5
"Region5","retail","Gaming Zone","March",12,3,3,5,4,10,374,397,14,23,384,27,411,3,4,4,4,3,4
"Region5","retail","Gaming Zone","April",11,5,5,2,4,11,417,440,15,23,428,27,455,3,5,2,2,2,3
"Region5","retail","Gaming Zone","May",11,4,4,5,4,13,486,510,17,24,499,28,527,2,4,4,2,4,4
"Region5","retail","Gaming Zone","June",12,2,5,5,3,14,408,432,17,24,422,27,449,3,4,3,3,3,3
"Region5","retail","Gaming Zone","July",11,2,3,2,3,11,427,445,14,18,438,21,459,2,2,4,3,3,3
"Region5","retail","Gaming Zone","August",13,3,5,5,4,14,338,364,18,26,352,30,382,4,4,3,2,3,4
"Region5","retail","Gaming Zone","September",13,5,2,3,2,14,404,427,16,23,418,25,443,5,3,4,3,4,5
"Region5","retail","Gaming Zone","October",11,5,3,5,2,12,404,428,14,24,416,26,442,4,4,3,3,2,4
"Region5","retail","Gaming Zone","November",13,3,3,4,3,11,423,446,14,23,434,26,460,3,3,3,4,4,2
"Region5","retail","Super MArket","January",11,3,4,3,2,12,366,387,14,21,378,23,401,2,3,5,3,3,5
"Region5","retail","Super MArket","February",13,4,2,3,2,11,328,350,13,22,339,24,363,3,4,5,3,2,3
"Region5","retail","Super MArket","March",11,5,3,2,4,12,318,339,16,21,330,25,355,3,5,3,3,2,3
"Region5","retail","Super MArket","April",10,3,4,5,3,12,351,373,15,22,363,25,388,2,4,3,3,3,4
"Region5","retail","Super MArket","May",11,4,3,2,5,15,478,498,20,20,493,25,518,2,2,3,4,4,3
"Region5","retail","Super MArket","June",10,5,3,3,4,12,466,487,16,21,478,25,503,4,4,4,4,4,2
"Region5","retail","Super MArket","July",13,3,4,3,4,11,378,401,15,23,389,27,416,5,4,4,4,5,3
"Region5","retail","Super MArket","August",11,3,5,5,4,13,409,433,17,24,422,28,450,3,3,3,4,3,2
"Region5","retail","Super MArket","September",11,4,4,4,4,12,416,439,16,23,428,27,455,3,4,2,2,3,3
"Region5","retail","Super MArket","October",11,4,5,4,4,11,355,379,15,24,366,28,394,3,2,2,4,3,4
"Region5","retail","Super MArket","November",11,4,3,5,4,10,302,325,14,23,312,27,339,3,3,3,2,4,5
"Region5","retail","Fast Food Centre","January",12,4,3,2,4,14,475,496,18,21,489,25,514,3,5,3,4,3,4
"Region5","retail","Fast Food Centre","February",10,2,4,4,4,11,347,367,15,20,358,24,382,4,4,4,3,5,5
"Region5","retail","Fast Food Centre","March",12,3,2,3,3,12,360,380,15,20,372,23,395,3,4,5,2,4,5
"Region5","retail","Fast Food Centre","April",11,3,4,2,2,10,380,400,12,20,390,22,412,5,4,4,3,5,2
"Region5","retail","Fast Food Centre","May",12,4,3,3,4,11,365,387,15,22,376,26,402,5,3,2,5,2,2
"Region5","retail","Fast Food Centre","June",11,5,3,2,4,13,454,475,17,21,467,25,492,4,5,3,3,4,3
"Region5","retail","Fast Food Centre","July",11,4,4,2,3,14,331,352,17,21,345,24,369,5,4,2,3,4,3
"Region5","retail","Fast Food Centre","August",12,3,4,4,4,14,462,485,18,23,476,27,503,4,3,5,3,4,3
"Region5","retail","Fast Food Centre","September",12,4,4,3,3,11,493,516,14,23,504,26,530,4,4,5,5,4,4
"Region5","retail","Fast Food Centre","October",12,4,2,3,2,15,433,454,17,21,448,23,471,2,2,3,3,4,4
"Region5","retail","Fast Food Centre","November",12,4,5,4,3,10,462,487,13,25,472,28,500,5,4,4,3,2,3
"Region5","holding","Retail Store","January",10,3,5,2,2,12,425,445,14,20,437,22,459,2,4,4,5,2,4
"Region5","holding","Retail Store","February",11,3,5,3,4,13,363,385,17,22,376,26,402,2,3,4,3,2,2
"Region5","holding","Retail Store","March",11,4,4,4,4,14,455,478,18,23,469,27,496,3,3,3,4,2,5
"Region5","holding","Retail Store","April",13,3,4,5,2,12,428,453,14,25,440,27,467,2,3,3,2,3,4
"Region5","holding","Retail Store","May",11,2,2,4,4,14,395,414,18,19,409,23,432,4,3,5,3,2,5
"Region5","holding","Retail Store","June",13,4,3,4,5,14,373,397,19,24,387,29,416,4,3,4,3,3,4
"Region5","holding","Retail Store","July",13,2,4,5,4,12,411,435,16,24,423,28,451,3,4,3,4,4,4
"Region5","holding","Retail Store","August",11,3,4,3,3,14,494,515,17,21,508,24,532,5,5,3,3,4,5
"Region5","holding","Retail Store","September",13,4,5,2,4,13,403,427,17,24,416,28,444,3,4,4,4,4,2
"Region5","holding","Retail Store","October",11,4,5,5,5,11,363,388,16,25,374,30,404,3,3,3,4,5,4
"Region5","holding","Retail Store","November",11,2,4,3,5,14,423,443,19,20,437,25,462,3,5,5,2,2,4
"Region5","holding","Kirana Store","January",12,2,3,4,2,13,431,452,15,21,444,23,467,4,3,3,4,2,2
"Region5","holding","Kirana Store","February",13,4,3,4,5,15,362,386,20,24,377,29,406,5,2,3,4,3,3
"Region5","holding","Kirana Store","March",11,2,5,3,2,11,405,426,13,21,416,23,439,3,4,2,3,4,4
"Region5","holding","Kirana Store","April",12,3,4,4,3,13,311,334,16,23,324,26,350,5,5,3,2,3,3
"Region5","holding","Kirana Store","May",11,2,2,2,3,12,467,484,15,17,479,20,499,2,2,2,4,2,3
"Region5","holding","Kirana Store","June",11,3,2,3,5,14,489,508,19,19,503,24,527,4,2,3,5,5,3
"Region5","holding","Kirana Store","July",10,2,5,3,5,13,400,420,18,20,413,25,438,3,3,4,2,4,3
"Region5","holding","Kirana Store","August",13,5,2,3,5,14,438,461,19,23,452,28,480,3,3,3,3,3,4
"Region5","holding","Kirana Store","September",10,3,4,3,2,11,329,349,13,20,340,22,362,4,4,3,3,4,4
"Region5","holding","Kirana Store","October",12,4,3,3,3,14,351,373,17,22,365,25,390,2,3,3,3,3,2
"Region5","holding","Kirana Store","November",12,5,3,4,3,13,474,498,16,24,487,27,514,3,5,2,4,2,4
"Region5","holding","Hotels","January",13,5,3,2,3,14,457,480,17,23,471,26,497,2,4,3,4,3,3
"Region5","holding","Hotels","February",11,4,3,5,3,11,405,428,14,23,416,26,442,4,4,3,3,3,4
"Region5","holding","Hotels","March",12,4,2,4,3,15,410,432,18,22,425,25,450,4,3,3,2,3,3
"Region5","holding","Hotels","April",11,3,3,4,4,11,485,506,15,21,496,25,521,2,4,4,3,2,4
"Region5","holding","Hotels","May",11,4,3,5,3,11,302,325,14,23,313,26,339,3,2,5,5,4,3
"Region5","holding","Hotels","June",12,2,2,3,4,14,363,382,18,19,377,23,400,2,2,3,3,2,4
"Region5","holding","Hotels","July",10,4,4,4,3,13,381,403,16,22,394,25,419,3,4,5,4,5,2
"Region5","holding","Hotels","August",12,5,4,4,2,13,469,494,15,25,482,27,509,3,5,3,3,3,4
"Region5","holding","Hotels","September",12,2,4,5,4,13,340,363,17,23,353,27,380,3,4,4,3,5,3
"Region5","holding","Hotels","October",11,3,3,4,3,12,417,438,15,21,429,24,453,4,4,2,3,3,3
"Region5","holding","Hotels","November",12,4,2,4,3,11,379,401,14,22,390,25,415,4,2,4,2,2,3
"Region5","holding","Restaurants","January",12,4,5,4,2,12,413,438,14,25,425,27,452,3,4,4,5,2,5
"Region5","holding","Restaurants","February",10,4,2,2,5,14,336,354,19,18,350,23,373,5,5,3,2,5,2
"Region5","holding","Restaurants","March",11,5,4,5,2,11,402,427,13,25,413,27,440,4,4,4,2,2,3
"Region5","holding","Restaurants","April",10,2,4,2,3,13,357,375,16,18,370,21,391,4,3,4,3,2,4
"Region5","holding","Restaurants","May",12,2,3,4,3,13,371,392,16,21,384,24,408,2,2,4,3,5,5
"Region5","holding","Restaurants","June",12,4,3,4,4,12,306,329,16,23,318,27,345,3,4,3,3,3,4
"Region5","holding","Restaurants","July",13,3,3,3,2,14,301,323,16,22,315,24,339,3,3,3,5,4,3
"Region5","holding","Restaurants","August",13,2,5,4,3,15,316,340,18,24,331,27,358,3,3,4,4,5,4
"Region5","holding","Restaurants","September",10,5,2,3,2,11,412,432,13,20,423,22,445,4,4,3,3,4,4
"Region5","holding","Restaurants","October",13,3,4,2,4,15,400,422,19,22,415,26,441,3,2,4,4,3,4
"Region5","holding","Restaurants","November",12,4,5,5,2,11,455,481,13,26,466,28,494,2,3,5,3,5,3
"Region5","holding","Airline","January",11,2,4,3,5,14,437,457,19,20,451,25,476,5,4,2,2,5,3
"Region5","holding","Airline","February",11,2,4,3,5,12,461,481,17,20,473,25,498,3,2,3,4,3,3
"Region5","holding","Airline","March",11,3,4,2,4,14,478,498,18,20,492,24,516,5,4,4,3,3,5
"Region5","holding","Airline","April",12,4,2,2,4,10,451,471,14,20,461,24,485,3,3,3,3,4,3
"Region5","holding","Airline","May",11,4,2,3,3,10,482,502,13,20,492,23,515,4,4,3,3,4,3
"Region5","holding","Airline","June",11,2,4,3,2,15,411,431,17,20,426,22,448,4,5,4,3,3,4
"Region5","holding","Airline","July",11,4,3,4,2,15,475,497,17,22,490,24,514,4,3,4,3,2,3
"Region5","holding","Airline","August",11,3,4,5,4,13,445,468,17,23,458,27,485,5,4,3,4,4,3
"Region5","holding","Airline","September",11,4,5,4,5,11,346,370,16,24,357,29,386,3,3,3,5,4,4
"Region5","holding","Airline","October",12,3,3,5,5,14,355,378,19,23,369,28,397,5,3,4,4,3,3
"Region5","holding","Airline","November",13,5,3,5,5,11,360,386,16,26,371,31,402,4,5,3,3,4,4
"Region5","holding","Hardware Store","January",10,3,2,3,2,11,466,484,13,18,477,20,497,5,3,4,3,3,5
"Region5","holding","Hardware Store","February",13,3,4,4,4,14,347,371,18,24,361,28,389,4,2,5,5,4,3
"Region5","holding","Hardware Store","March",11,2,2,3,5,11,352,370,16,18,363,23,386,3,5,5,3,4,3
"Region5","holding","Hardware Store","April",12,3,5,2,3,15,303,325,18,22,318,25,343,4,4,5,3,2,4
"Region5","holding","Hardware Store","May",13,3,3,3,4,12,453,475,16,22,465,26,491,2,3,3,5,5,5
"Region5","holding","Hardware Store","June",12,4,4,4,2,11,389,413,13,24,400,26,426,5,3,3,4,5,5
"Region5","holding","Hardware Store","July",12,2,4,3,2,14,396,417,16,21,410,23,433,4,3,4,5,3,3
"Region5","holding","Hardware Store","August",13,3,4,3,3,14,318,341,17,23,332,26,358,4,2,2,3,4,2
"Region5","holding","Hardware Store","September",12,5,3,4,3,15,308,332,18,24,323,27,350,2,4,5,3,4,3
"Region5","holding","Hardware Store","October",11,4,3,5,3,11,463,486,14,23,474,26,500,2,3,3,4,4,3
"Region5","holding","Hardware Store","November",11,5,5,3,4,12,413,437,16,24,425,28,453,4,2,3,2,3,5
"Region5","holding","Computer Store","January",11,2,3,3,4,12,369,388,16,19,381,23,404,4,2,5,5,4,3
"Region5","holding","Computer Store","February",12,3,3,4,4,11,336,358,15,22,347,26,373,3,4,3,5,3,5
"Region5","holding","Computer Store","March",11,3,3,3,4,14,322,342,18,20,336,24,360,4,3,3,5,5,4
"Region5","holding","Computer Store","April",10,3,3,3,4,10,341,360,14,19,351,23,374,4,3,3,2,5,3
"Region5","holding","Computer Store","May",10,4,2,4,2,14,456,476,16,20,470,22,492,3,4,4,2,4,3
"Region5","holding","Computer Store","June",11,5,4,2,3,11,444,466,14,22,455,25,480,2,4,5,2,5,3
"Region5","holding","Computer Store","July",10,2,3,2,2,14,434,451,16,17,448,19,467,2,2,3,5,4,5
"Region5","holding","Computer Store","August",13,3,5,5,2,10,465,491,12,26,475,28,503,3,3,3,5,3,3
"Region5","holding","Computer Store","September",11,3,2,5,2,13,448,469,15,21,461,23,484,4,4,5,4,4,4
"Region5","holding","Computer Store","October",11,3,5,4,4,13,392,415,17,23,405,27,432,2,3,3,3,5,2
"Region5","holding","Computer Store","November",10,4,3,2,3,11,364,383,14,19,375,22,397,4,5,4,4,3,5
"Region5","holding","Gaming Zone","January",11,4,2,3,2,11,335,355,13,20,346,22,368,2,3,3,4,4,4
"Region5","holding","Gaming Zone","February",11,3,3,5,3,11,313,335,14,22,324,25,349,4,2,4,3,3,4
"Region5","holding","Gaming Zone","March",10,3,3,3,5,14,456,475,19,19,470,24,494,5,3,3,3,3,3
"Region5","holding","Gaming Zone","April",13,3,3,5,3,14,417,441,17,24,431,27,458,3,3,3,3,3,2
"Region5","holding","Gaming Zone","May",12,3,2,4,4,14,442,463,18,21,456,25,481,4,3,3,3,5,5
"Region5","holding","Gaming Zone","June",13,3,3,3,2,11,334,356,13,22,345,24,369,5,3,4,3,4,5
"Region5","holding","Gaming Zone","July",12,4,5,3,2,14,470,494,16,24,484,26,510,2,5,2,3,5,4
"Region5","holding","Gaming Zone","August",10,3,5,5,4,11,454,477,15,23,465,27,492,5,4,5,2,5,3
"Region5","holding","Gaming Zone","September",10,3,5,5,5,13,417,440,18,23,430,28,458,4,4,5,3,4,4
"Region5","holding","Gaming Zone","October",13,4,3,2,3,14,488,510,17,22,502,25,527,2,4,3,4,4,5
"Region5","holding","Gaming Zone","November",12,5,5,3,4,12,328,353,16,25,340,29,369,2,4,5,4,3,4
"Region5","holding","Super MArket","January",12,2,3,3,4,14,389,409,18,20,403,24,427,3,3,4,3,2,3
"Region5","holding","Super MArket","February",11,4,4,3,4,12,304,326,16,22,316,26,342,3,5,3,3,3,3
"Region5","holding","Super MArket","March",12,3,3,3,4,14,469,490,18,21,483,25,508,4,4,2,4,3,5
"Region5","holding","Super MArket","April",12,4,4,5,2,11,315,340,13,25,326,27,353,3,5,2,5,4,3
"Region5","holding","Super MArket","May",10,5,5,4,4,14,445,469,18,24,459,28,487,5,3,4,4,3,3
"Region5","holding","Super MArket","June",12,3,4,5,4,11,426,450,15,24,437,28,465,2,3,2,4,4,3
"Region5","holding","Super MArket","July",11,4,5,2,3,11,319,341,14,22,330,25,355,4,4,4,4,3,4
"Region5","holding","Super MArket","August",11,4,4,4,2,14,411,434,16,23,425,25,450,2,3,2,5,4,4
"Region5","holding","Super MArket","September",11,4,3,5,5,14,307,330,19,23,321,28,349,4,4,4,4,5,5
"Region5","holding","Super MArket","October",13,4,3,3,5,15,385,408,20,23,400,28,428,3,5,5,4,3,3
"Region5","holding","Super MArket","November",13,4,5,5,4,14,448,475,18,27,462,31,493,4,3,2,3,3,3
"Region5","holding","Fast Food Centre","January",13,3,5,4,2,14,478,503,16,25,492,27,519,5,4,4,4,4,3
"Region5","holding","Fast Food Centre","February",10,3,5,2,4,13,315,335,17,20,328,24,352,5,2,3,5,4,3
"Region5","holding","Fast Food Centre","March",11,4,4,4,3,11,468,491,14,23,479,26,505,4,2,3,2,4,5
"Region5","holding","Fast Food Centre","April",10,2,5,4,3,11,375,396,14,21,386,24,410,5,3,4,5,4,4
"Region5","holding","Fast Food Centre","May",12,3,5,4,4,13,475,499,17,24,488,28,516,3,4,4,2,2,2
"Region5","holding","Fast Food Centre","June",13,4,4,5,3,14,425,451,17,26,439,29,468,3,5,3,3,4,4
"Region5","holding","Fast Food Centre","July",12,3,5,2,5,10,455,477,15,22,465,27,492,3,3,4,5,5,3
"Region5","holding","Fast Food Centre","August",13,2,3,2,3,11,325,345,14,20,336,23,359,3,5,3,3,5,2
"Region5","holding","Fast Food Centre","September",13,4,2,2,3,13,497,518,16,21,510,24,534,5,4,4,4,2,5
"Region5","holding","Fast Food Centre","October",12,3,3,4,5,13,392,414,18,22,405,27,432,4,2,4,2,2,4
"Region5","holding","Fast Food Centre","November",10,3,4,5,4,11,483,505,15,22,494,26,520,4,3,2,5,4,3
"Region6","retail","Retail Store","January",13,5,4,4,3,12,358,384,15,26,370,29,399,3,2,3,4,3,4
"Region6","retail","Retail Store","February",12,3,2,2,2,11,460,479,13,19,471,21,492,2,5,3,4,4,3
"Region6","retail","Retail Store","March",13,4,4,3,4,13,470,494,17,24,483,28,511,3,2,3,4,4,4
"Region6","retail","Retail Store","April",11,2,3,5,4,11,351,372,15,21,362,25,387,5,4,3,2,2,4
"Region6","retail","Retail Store","May",12,4,4,4,4,14,450,474,18,24,464,28,492,3,4,5,2,4,5
"Region6","retail","Retail Store","June",12,3,3,2,3,12,405,425,15,20,417,23,440,4,3,5,3,4,4
"Region6","retail","Retail Store","July",10,2,3,3,4,12,327,345,16,18,339,22,361,4,4,4,3,3,3
"Region6","retail","Retail Store","August",13,3,2,3,3,13,315,336,16,21,328,24,352,4,4,5,4,3,4
"Region6","retail","Retail Store","September",11,3,4,3,3,11,382,403,14,21,393,24,417,4,4,2,4,4,3
"Region6","retail","Retail Store","October",11,2,5,2,4,15,325,345,19,20,340,24,364,2,2,3,2,5,4
"Region6","retail","Retail Store","November",11,3,2,3,4,14,311,330,18,19,325,23,348,4,4,5,3,3,3
"Region6","retail","Kirana Store","January",11,5,4,2,3,13,463,485,16,22,476,25,501,2,4,5,3,5,2
"Region6","retail","Kirana Store","February",12,4,2,3,2,11,367,388,13,21,378,23,401,5,4,4,4,3,3
"Region6","retail","Kirana Store","March",10,3,4,3,4,13,358,378,17,20,371,24,395,3,4,3,3,3,2
"Region6","retail","Kirana Store","April",10,3,3,3,4,15,381,400,19,19,396,23,419,4,3,3,3,4,4
"Region6","retail","Kirana Store","May",11,3,3,4,3,12,438,459,15,21,450,24,474,5,3,3,4,3,2
"Region6","retail","Kirana Store","June",10,3,2,3,5,14,452,470,19,18,466,23,489,4,3,3,3,3,4
"Region6","retail","Kirana Store","July",13,5,3,4,4,11,321,346,15,25,332,29,361,3,2,4,4,5,4
"Region6","retail","Kirana Store","August",13,2,5,4,4,14,461,485,18,24,475,28,503,4,5,2,4,3,3
"Region6","retail","Kirana Store","September",11,3,3,3,5,10,442,462,15,20,452,25,477,4,2,2,4,3,5
"Region6","retail","Kirana Store","October",12,4,3,3,5,10,373,395,15,22,383,27,410,3,3,5,3,2,4
"Region6","retail","Kirana Store","November",12,5,4,5,4,11,314,340,15,26,325,30,355,2,4,3,3,3,4
"Region6","retail","Hotels","January",12,5,3,4,3,13,314,338,16,24,327,27,354,3,5,4,2,3,4
"Region6","retail","Hotels","February",13,3,2,5,3,14,348,371,17,23,362,26,388,4,4,3,3,4,3
"Region6","retail","Hotels","March",13,3,5,3,5,12,379,403,17,24,391,29,420,3,3,2,3,5,3
"Region6","retail","Hotels","April",10,3,3,3,4,11,463,482,15,19,474,23,497,3,4,2,4,4,3
"Region6","retail","Hotels","May",11,4,4,2,4,13,306,327,17,21,319,25,344,2,2,3,3,4,3
"Region6","retail","Hotels","June",12,5,4,3,4,14,456,480,18,24,470,28,498,4,4,2,3,5,4
"Region6","retail","Hotels","July",11,5,3,3,2,12,436,458,14,22,448,24,472,3,4,4,4,3,4
"Region6","retail","Hotels","August",12,5,4,2,2,15,460,483,17,23,475,25,500,3,4,3,5,4,3
"Region6","retail","Hotels","September",10,5,4,5,4,14,495,519,18,24,509,28,537,2,5,2,3,5,2
"Region6","retail","Hotels","October",11,4,4,3,5,15,432,454,20,22,447,27,474,3,3,4,4,4,5
"Region6","retail","Hotels","November",11,2,2,3,4,15,412,430,19,18,427,22,449,5,2,3,2,3,3
"Region6","retail","Restaurants","January",10,3,3,3,4,12,383,402,16,19,395,23,418,3,3,4,5,2,3
"Region6","retail","Restaurants","February",10,4,2,3,5,14,454,473,19,19,468,24,492,3,4,2,3,4,4
"Region6","retail","Restaurants","March",13,3,4,2,3,12,345,367,15,22,357,25,382,5,4,3,5,4,4
"Region6","retail","Restaurants","April",11,3,2,2,3,12,362,380,15,18,374,21,395,2,4,4,2,3,3
"Region6","retail","Restaurants","May",11,5,4,4,4,12,361,385,16,24,373,28,401,3,3,3,4,4,2
"Region6","retail","Restaurants","June",11,5,2,4,5,13,395,417,18,22,408,27,435,2,3,5,3,4,4
"Region6","retail","Restaurants","July",13,5,4,4,2,13,494,520,15,26,507,28,535,4,3,4,4,5,4
"Region6","retail","Restaurants","August",13,5,4,3,4,14,405,430,18,25,419,29,448,3,5,4,2,3,4
"Region6","retail","Restaurants","September",11,5,3,3,3,13,400,422,16,22,413,25,438,5,3,2,5,3,3
"Region6","retail","Restaurants","October",12,2,5,4,2,11,475,498,13,23,486,25,511,3,3,4,5,2,3
"Region6","retail","Restaurants","November",10,5,5,4,3,12,436,460,15,24,448,27,475,5,2,5,4,4,4
"Region6","retail","Airline","January",12,4,5,4,2,13,493,518,15,25,506,27,533,3,2,3,5,2,5
"Region6","retail","Airline","February",11,5,4,4,4,11,495,519,15,24,506,28,534,4,3,4,3,4,3
"Region6","retail","Airline","March",13,3,5,4,5,12,479,504,17,25,491,30,521,3,4,4,5,4,5
"Region6","retail","Airline","April",10,4,3,4,3,13,311,332,16,21,324,24,348,4,5,3,5,3,3
"Region6","retail","Airline","May",11,4,3,3,4,13,435,456,17,21,448,25,473,2,3,2,5,5,5
"Region6","retail","Airline","June",11,3,3,5,4,13,460,482,17,22,473,26,499,3,5,4,3,3,3
"Region6","retail","Airline","July",11,2,4,5,3,14,471,493,17,22,485,25,510,4,4,2,4,4,2
"Region6","retail","Airline","August",11,3,3,4,2,14,495,516,16,21,509,23,532,3,3,3,3,4,4
"Region6","retail","Airline","September",12,5,4,3,3,11,334,358,14,24,345,27,372,5,3,2,4,4,3
"Region6","retail","Airline","October",13,4,3,4,3,11,391,415,14,24,402,27,429,4,5,4,4,4,2
"Region6","retail","Airline","November",12,3,3,5,3,13,307,330,16,23,320,26,346,3,5,4,3,2,4
"Region6","retail","Hardware Store","January",11,4,5,5,2,13,442,467,15,25,455,27,482,2,5,4,5,4,4
"Region6","retail","Hardware Store","February",12,3,3,3,4,11,440,461,15,21,451,25,476,5,5,2,2,2,3
"Region6","retail","Hardware Store","March",10,4,3,4,5,14,321,342,19,21,335,26,361,4,5,3,3,4,5
"Region6","retail","Hardware Store","April",12,4,3,2,4,13,306,327,17,21,319,25,344,3,2,4,3,4,2
"Region6","retail","Hardware Store","May",11,3,4,4,2,14,317,339,16,22,331,24,355,3,3,4,2,4,3
"Region6","retail","Hardware Store","June",12,3,3,4,2,13,449,471,15,22,462,24,486,4,3,2,3,3,5
"Region6","retail","Hardware Store","July",10,4,3,2,4,12,398,417,16,19,410,23,433,3,5,2,3,4,2
"Region6","retail","Hardware Store","August",11,4,4,3,3,14,369,391,17,22,383,25,408,5,5,2,3,4,4
"Region6","retail","Hardware Store","September",11,4,5,2,2,12,389,411,14,22,401,24,425,3,2,5,2,4,3
"Region6","retail","Hardware Store","October",12,4,5,4,5,13,468,493,18,25,481,30,511,3,4,5,3,4,3
"Region6","retail","Hardware Store","November",12,3,4,3,4,11,423,445,15,22,434,26,460,2,3,3,2,5,2
"Region6","retail","Computer Store","January",10,4,5,4,2,12,481,504,14,23,493,25,518,3,5,2,4,3,4
"Region6","retail","Computer Store","February",11,4,5,2,3,12,312,334,15,22,324,25,349,2,4,5,2,4,2
"Region6","retail","Computer Store","March",11,2,3,4,2,13,476,496,15,20,489,22,511,5,3,3,5,3,4
"Region6","retail","Computer Store","April",11,2,3,4,5,11,499,519,16,20,510,25,535,5,2,4,3,2,4
"Region6","retail","Computer Store","May",13,4,4,5,2,14,479,505,16,26,493,28,521,4,4,4,3,3,3
"Region6","retail","Computer Store","June",11,5,3,4,2,11,428,451,13,23,439,25,464,5,2,3,3,3,5
"Region6","retail","Computer Store","July",11,4,4,2,2,13,341,362,15,21,354,23,377,3,3,5,3,4,3
"Region6","retail","Computer Store","August",11,4,3,5,3,12,399,422,15,23,411,26,437,3,3,2,4,3,3
"Region6","retail","Computer Store","September",12,3,5,3,2,11,492,515,13,23,503,25,528,3,4,5,3,4,4
"Region6","retail","Computer Store","October",12,2,3,5,2,11,412,434,13,22,423,24,447,4,2,2,3,5,2
"Region6","retail","Computer Store","November",11,2,4,2,4,12,384,403,16,19,396,23,419,3,4,4,4,4,4
"Region6","retail","Gaming Zone","January",13,2,3,4,2,11,355,377,13,22,366,24,390,3,4,3,4,3,4
"Region6","retail","Gaming Zone","February",12,3,3,4,2,12,449,471,14,22,461,24,485,4,2,4,3,4,3
"Region6","retail","Gaming Zone","March",11,2,3,4,2,14,381,401,16,20,395,22,417,3,3,2,4,4,2
"Region6","retail","Gaming Zone","April",11,4,2,2,4,14,455,474,18,19,469,23,492,3,3,4,4,3,4
"Region6","retail","Gaming Zone","May",11,2,3,3,2,12,438,457,14,19,450,21,471,5,4,2,4,5,2
"Region6","retail","Gaming Zone","June",11,5,5,3,2,14,340,364,16,24,354,26,380,5,4,4,4,2,4
"Region6","retail","Gaming Zone","July",10,5,4,3,3,13,470,492,16,22,483,25,508,4,3,3,3,4,2
"Region6","retail","Gaming Zone","August",12,3,5,3,5,13,449,472,18,23,462,28,490,3,5,4,4,2,4
"Region6","retail","Gaming Zone","September",11,3,4,2,3,14,381,401,17,20,395,23,418,3,3,3,3,5,4
"Region6","retail","Gaming Zone","October",13,2,4,5,4,14,429,453,18,24,443,28,471,3,5,5,2,4,4
"Region6","retail","Gaming Zone","November",13,4,3,3,2,12,448,471,14,23,460,25,485,2,4,2,4,4,5
"Region6","retail","Super MArket","January",12,5,4,3,4,13,490,514,17,24,503,28,531,4,3,3,5,2,4
"Region6","retail","Super MArket","February",11,3,4,3,2,13,349,370,15,21,362,23,385,5,3,2,4,5,3
"Region6","retail","Super MArket","March",12,4,5,4,3,11,420,445,14,25,431,28,459,4,4,2,3,3,3
"Region6","retail","Super MArket","April",11,4,2,5,3,11,416,438,14,22,427,25,452,5,2,3,3,4,3
"Region6","retail","Super MArket","May",11,3,2,3,4,14,364,383,18,19,378,23,401,4,3,4,3,5,3
"Region6","retail","Super MArket","June",12,3,3,4,4,13,457,479,17,22,470,26,496,4,3,2,3,5,3
"Region6","retail","Super MArket","July",12,3,2,3,4,13,407,427,17,20,420,24,444,3,3,4,5,4,4
"Region6","retail","Super MArket","August",11,3,3,4,4,12,367,388,16,21,379,25,404,5,2,4,5,4,2
"Region6","retail","Super MArket","September",12,5,5,3,5,12,400,425,17,25,412,30,442,2,4,3,3,3,3
"Region6","retail","Super MArket","October",10,4,3,4,4,11,340,361,15,21,351,25,376,4,4,4,4,3,3
"Region6","retail","Super MArket","November",13,4,2,5,3,10,318,342,13,24,328,27,355,3,2,2,4,2,5
"Region6","retail","Fast Food Centre","January",12,4,4,2,4,10,362,384,14,22,372,26,398,2,4,4,3,3,3
"Region6","retail","Fast Food Centre","February",12,3,3,3,5,11,361,382,16,21,372,26,398,3,4,3,3,5,4
"Region6","retail","Fast Food Centre","March",11,3,4,4,3,13,330,352,16,22,343,25,368,3,3,2,3,5,4
"Region6","retail","Fast Food Centre","April",12,5,2,2,5,13,499,520,18,21,512,26,538,3,4,2,2,3,4
"Region6","retail","Fast Food Centre","May",10,2,2,4,4,13,489,507,17,18,502,22,524,4,5,4,3,3,3
"Region6","retail","Fast Food Centre","June",11,4,4,3,5,15,494,516,20,22,509,27,536,3,3,4,5,3,5
"Region6","retail","Fast Food Centre","July",12,4,3,5,4,12,494,518,16,24,506,28,534,4,2,4,3,5,4
"Region6","retail","Fast Food Centre","August",12,3,3,3,3,11,389,410,14,21,400,24,424,5,2,3,3,2,3
"Region6","retail","Fast Food Centre","September",13,4,3,3,4,14,366,389,18,23,380,27,407,3,4,3,4,3,3
"Region6","retail","Fast Food Centre","October",12,5,2,2,4,10,426,447,14,21,436,25,461,3,3,3,3,4,3
"Region6","retail","Fast Food Centre","November",10,5,5,3,5,12,418,441,17,23,430,28,458,3,3,5,4,5,3
"Region6","holding","Retail Store","January",11,4,3,5,3,12,488,511,15,23,500,26,526,2,2,2,3,5,2
"Region6","holding","Retail Store","February",13,2,5,2,5,13,353,375,18,22,366,27,393,4,3,5,3,4,3
"Region6","holding","Retail Store","March",12,3,3,5,3,14,386,409,17,23,400,26,426,2,3,4,4,4,5
"Region6","holding","Retail Store","April",10,3,5,3,2,15,317,338,17,21,332,23,355,3,3,5,3,4,4
"Region6","holding","Retail Store","May",13,2,4,3,2,11,306,328,13,22,317,24,341,4,3,4,4,2,4
"Region6","holding","Retail Store","June",11,4,4,5,2,13,417,441,15,24,430,26,456,3,4,4,2,5,3
"Region6","holding","Retail Store","July",10,4,3,5,4,14,371,393,18,22,385,26,411,3,3,5,2,3,3
"Region6","holding","Retail Store","August",12,4,3,2,5,14,456,477,19,21,470,26,496,4,3,2,4,4,3
"Region6","holding","Retail Store","September",11,3,3,3,2,12,348,368,14,20,360,22,382,3,5,3,4,2,3
"Region6","holding","Retail Store","October",12,2,4,4,4,11,454,476,15,22,465,26,491,3,3,5,3,3,2
"Region6","holding","Retail Store","November",10,5,4,2,3,10,313,334,13,21,323,24,347,3,3,3,5,5,4
"Region6","holding","Kirana Store","January",10,3,4,3,3,11,358,378,14,20,369,23,392,3,4,3,4,4,5
"Region6","holding","Kirana Store","February",13,2,4,3,3,11,497,519,14,22,508,25,533,5,2,5,4,5,4
"Region6","holding","Kirana Store","March",10,3,2,4,4,12,424,443,16,19,436,23,459,4,3,4,3,5,4
"Region6","holding","Kirana Store","April",13,4,4,2,5,15,436,459,20,23,451,28,479,5,4,5,3,3,4
"Region6","holding","Kirana Store","May",10,5,4,3,4,15,478,500,19,22,493,26,519,3,3,4,5,2,5
"Region6","holding","Kirana Store","June",13,3,2,4,5,13,361,383,18,22,374,27,401,4,2,3,3,4,3
"Region6","holding","Kirana Store","July",10,4,5,4,2,14,353,376,16,23,367,25,392,3,2,4,5,2,3
"Region6","holding","Kirana Store","August",10,3,3,4,2,11,367,387,13,20,378,22,400,5,5,4,3,3,5
"Region6","holding","Kirana Store","September",13,4,4,3,3,15,499,523,18,24,514,27,541,2,3,2,3,4,3
"Region6","holding","Kirana Store","October",10,4,2,4,5,13,393,413,18,20,406,25,431,5,4,2,3,3,5
"Region6","holding","Kirana Store","November",11,5,2,4,5,12,341,363,17,22,353,27,380,2,5,4,4,4,2
"Region6","holding","Hotels","January",13,4,3,3,2,10,449,472,12,23,459,25,484,2,3,2,5,4,3
"Region6","holding","Hotels","February",12,4,5,4,5,12,318,343,17,25,330,30,360,4,3,4,5,3,3
"Region6","holding","Hotels","March",12,2,2,4,4,12,329,349,16,20,341,24,365,4,3,3,4,4,3
"Region6","holding","Hotels","April",11,5,5,5,3,10,411,437,13,26,421,29,450,4,4,2,5,2,5
"Region6","holding","Hotels","May",11,2,4,4,5,15,460,481,20,21,475,26,501,4,4,2,5,5,2
"Region6","holding","Hotels","June",11,4,4,3,4,10,331,353,14,22,341,26,367,4,4,2,4,3,4
"Region6","holding","Hotels","July",12,2,3,4,3,11,436,457,14,21,447,24,471,4,5,4,5,2,4
"Region6","holding","Hotels","August",10,3,2,3,2,14,310,328,16,18,324,20,344,4,3,5,3,5,2
"Region6","holding","Hotels","September",11,4,4,4,3,12,395,418,15,23,407,26,433,2,4,2,2,3,4
"Region6","holding","Hotels","October",13,3,4,2,2,10,380,402,12,22,390,24,414,4,5,4,3,4,4
"Region6","holding","Hotels","November",13,3,3,3,4,10,352,374,14,22,362,26,388,3,4,5,2,5,3
"Region6","holding","Restaurants","January",10,3,5,4,3,13,424,446,16,22,437,25,462,4,3,2,3,3,4
"Region6","holding","Restaurants","February",12,5,5,3,2,12,360,385,14,25,372,27,399,5,3,4,4,4,5
"Region6","holding","Restaurants","March",13,2,5,3,3,10,353,376,13,23,363,26,389,4,3,3,3,3,3
"Region6","holding","Restaurants","April",10,4,4,3,4,12,312,333,16,21,324,25,349,5,3,3,4,5,3
"Region6","holding","Restaurants","May",10,4,4,2,4,11,473,493,15,20,484,24,508,4,3,4,3,5,4
"Region6","holding","Restaurants","June",10,3,3,4,4,12,345,365,16,20,357,24,381,4,4,3,3,2,3
"Region6","holding","Restaurants","July",11,3,5,3,4,11,350,372,15,22,361,26,387,3,2,3,4,3,3
"Region6","holding","Restaurants","August",12,3,3,5,3,15,446,469,18,23,461,26,487,4,3,4,5,3,5
"Region6","holding","Restaurants","September",12,3,5,3,3,10,478,501,13,23,488,26,514,5,4,3,5,2,2
"Region6","holding","Restaurants","October",12,4,4,2,3,10,317,339,13,22,327,25,352,4,4,4,5,5,4
"Region6","holding","Restaurants","November",12,2,5,5,3,11,428,452,14,24,439,27,466,4,2,4,5,4,4
"Region6","holding","Airline","January",13,4,2,4,2,12,373,396,14,23,385,25,410,4,4,4,4,2,3
"Region6","holding","Airline","February",11,2,5,3,3,10,437,458,13,21,447,24,471,5,4,5,3,4,3
"Region6","holding","Airline","March",12,5,3,3,4,12,482,505,16,23,494,27,521,3,3,4,3,3,3
"Region6","holding","Airline","April",11,3,5,3,4,11,312,334,15,22,323,26,349,2,2,3,5,3,5
"Region6","holding","Airline","May",12,5,4,4,3,15,414,439,18,25,429,28,457,5,3,3,3,2,4
"Region6","holding","Airline","June",11,4,2,3,5,14,349,369,19,20,363,25,388,4,3,4,4,2,2
"Region6","holding","Airline","July",10,4,4,5,3,10,387,410,13,23,397,26,423,2,4,4,4,3,3
"Region6","holding","Airline","August",11,4,5,4,5,11,398,422,16,24,409,29,438,4,5,4,2,5,3
"Region6","holding","Airline","September",11,5,4,2,5,12,364,386,17,22,376,27,403,3,4,2,2,5,4
"Region6","holding","Airline","October",10,3,2,5,3,12,456,476,15,20,468,23,491,4,5,4,4,3,4
"Region6","holding","Airline","November",10,5,4,5,2,12,487,511,14,24,499,26,525,3,3,5,5,3,4
"Region6","holding","Hardware Store","January",11,3,3,4,3,13,474,495,16,21,487,24,511,3,3,5,3,2,4
"Region6","holding","Hardware Store","February",12,3,4,5,3,11,451,475,14,24,462,27,489,3,4,2,2,3,4
"Region6","holding","Hardware Store","March",12,5,5,5,4,15,314,341,19,27,329,31,360,2,4,5,2,5,3
"Region6","holding","Hardware Store","April",11,3,3,5,3,15,464,486,18,22,479,25,504,2,2,3,5,4,2
"Region6","holding","Hardware Store","May",12,4,4,3,2,13,377,400,15,23,390,25,415,4,3,4,4,3,5
"Region6","holding","Hardware Store","June",10,3,2,2,5,13,425,442,18,17,438,22,460,5,4,5,4,4,4
"Region6","holding","Hardware Store","July",12,3,5,2,3,13,360,382,16,22,373,25,398,4,2,4,5,5,2
"Region6","holding","Hardware Store","August",12,4,4,4,4,15,352,376,19,24,367,28,395,3,4,4,3,4,5
"Region6","holding","Hardware Store","September",13,3,3,4,5,10,375,398,15,23,385,28,413,3,2,3,4,3,2
"Region6","holding","Hardware Store","October",12,3,3,4,3,10,321,343,13,22,331,25,356,2,2,2,3,3,5
"Region6","holding","Hardware Store","November",12,3,5,4,4,10,353,377,14,24,363,28,391,5,3,5,4,5,4
"Region6","holding","Computer Store","January",11,4,3,5,3,11,396,419,14,23,407,26,433,2,2,2,4,3,4
"Region6","holding","Computer Store","February",12,3,4,3,4,11,324,346,15,22,335,26,361,2,5,4,3,4,2
"Region6","holding","Computer Store","March",11,4,4,3,4,12,303,325,16,22,315,26,341,4,3,2,3,4,5
"Region6","holding","Computer Store","April",12,3,2,5,4,14,326,348,18,22,340,26,366,2,3,4,3,4,3
"Region6","holding","Computer Store","May",13,4,3,4,4,11,392,416,15,24,403,28,431,2,3,3,3,3,5
"Region6","holding","Computer Store","June",10,2,3,5,5,13,330,350,18,20,343,25,368,2,4,3,3,4,4
"Region6","holding","Computer Store","July",13,3,2,2,4,15,444,464,19,20,459,24,483,4,5,3,2,3,2
"Region6","holding","Computer Store","August",11,2,3,2,3,13,395,413,16,18,408,21,429,4,5,5,4,4,2
"Region6","holding","Computer Store","September",11,4,4,2,3,14,492,513,17,21,506,24,530,3,4,3,4,3,4
"Region6","holding","Computer Store","October",11,2,4,4,2,12,388,409,14,21,400,23,423,4,4,5,4,4,3
"Region6","holding","Computer Store","November",13,4,3,4,4,12,354,378,16,24,366,28,394,4,4,4,4,3,4
"Region6","holding","Gaming Zone","January",11,4,4,4,3,12,422,445,15,23,434,26,460,5,2,3,5,3,5
"Region6","holding","Gaming Zone","February",12,2,3,4,3,11,498,519,14,21,509,24,533,2,3,3,5,3,4
"Region6","holding","Gaming Zone","March",12,4,3,2,3,13,451,472,16,21,464,24,488,4,4,3,4,3,4
"Region6","holding","Gaming Zone","April",11,4,3,3,3,13,397,418,16,21,410,24,434,4,4,4,2,5,5
"Region6","holding","Gaming Zone","May",12,4,4,3,4,12,309,332,16,23,321,27,348,4,5,2,3,3,4
"Region6","holding","Gaming Zone","June",11,3,3,2,4,11,310,329,15,19,321,23,344,4,3,3,4,3,3
"Region6","holding","Gaming Zone","July",10,2,4,2,2,10,459,477,12,18,469,20,489,4,5,3,5,4,2
"Region6","holding","Gaming Zone","August",11,3,3,3,4,12,470,490,16,20,482,24,506,3,3,3,3,4,4
"Region6","holding","Gaming Zone","September",12,4,3,4,2,12,351,374,14,23,363,25,388,3,4,2,5,2,5
"Region6","holding","Gaming Zone","October",11,3,4,5,4,11,440,463,15,23,451,27,478,2,5,4,4,3,3
"Region6","holding","Gaming Zone","November",13,4,5,3,3,12,485,510,15,25,497,28,525,4,3,2,4,3,4
"Region6","holding","Super MArket","January",11,3,4,4,2,10,314,336,12,22,324,24,348,2,5,4,2,3,3
"Region6","holding","Super MArket","February",10,4,4,4,5,14,473,495,19,22,487,27,514,3,3,4,4,4,5
"Region6","holding","Super MArket","March",12,4,2,4,2,13,379,401,15,22,392,24,416,3,3,5,3,4,4
"Region6","holding","Super MArket","April",12,3,2,3,3,10,496,516,13,20,506,23,529,5,5,3,4,4,3
"Region6","holding","Super MArket","May",11,2,4,4,5,13,485,506,18,21,498,26,524,3,3,3,2,3,4
"Region6","holding","Super MArket","June",10,3,4,5,5,10,357,379,15,22,367,27,394,4,2,2,5,4,3
"Region6","holding","Super MArket","July",11,4,3,2,3,12,446,466,15,20,458,23,481,4,4,5,3,2,4
"Region6","holding","Super MArket","August",11,4,4,4,4,12,409,432,16,23,421,27,448,4,2,4,2,2,4
"Region6","holding","Super MArket","September",11,3,3,4,3,10,476,497,13,21,486,24,510,4,5,3,4,4,3
"Region6","holding","Super MArket","October",10,3,5,2,4,15,473,493,19,20,488,24,512,4,4,4,4,3,5
"Region6","holding","Super MArket","November",13,3,4,4,3,14,433,457,17,24,447,27,474,2,3,4,2,5,2
"Region6","holding","Fast Food Centre","January",12,3,3,4,2,15,474,496,17,22,489,24,513,5,3,4,4,3,5
"Region6","holding","Fast Food Centre","February",11,2,2,2,3,11,435,452,14,17,446,20,466,5,4,5,4,2,4
"Region6","holding","Fast Food Centre","March",11,4,3,3,2,13,393,414,15,21,406,23,429,4,2,3,4,3,3
"Region6","holding","Fast Food Centre","April",10,4,3,4,3,15,306,327,18,21,321,24,345,4,3,4,3,2,2
"Region6","holding","Fast Food Centre","May",11,4,2,5,4,14,418,440,18,22,432,26,458,3,4,5,2,4,3
"Region6","holding","Fast Food Centre","June",12,3,3,3,2,13,307,328,15,21,320,23,343,4,4,4,4,4,3
"Region6","holding","Fast Food Centre","July",12,4,3,3,2,11,391,413,13,22,402,24,426,4,2,3,5,3,2
"Region6","holding","Fast Food Centre","August",11,3,4,4,3,12,301,323,15,22,313,25,338,4,4,3,3,2,5
"Region6","holding","Fast Food Centre","September",11,4,5,3,5,10,315,338,15,23,325,28,353,3,2,5,5,3,3
"Region6","holding","Fast Food Centre","October",13,2,3,3,2,12,405,426,14,21,417,23,440,4,3,4,3,4,3
"Region6","holding","Fast Food Centre","November",11,4,2,3,4,14,314,334,18,20,328,24,352,2,3,2,4,4,4
"Region7","retail","Retail Store","January",12,5,3,3,3,11,426,449,14,23,437,26,463,4,5,3,2,3,2
"Region7","retail","Retail Store","February",13,3,4,4,3,15,487,511,18,24,502,27,529,5,4,2,2,4,5
"Region7","retail","Retail Store","March",13,5,5,4,3,13,480,507,16,27,493,30,523,2,2,4,3,5,4
"Region7","retail","Retail Store","April",13,4,4,3,4,13,451,475,17,24,464,28,492,5,4,3,3,5,3
"Region7","retail","Retail Store","May",11,4,3,4,2,15,456,478,17,22,471,24,495,3,4,5,4,4,5
"Region7","retail","Retail Store","June",10,2,3,3,3,13,399,417,16,18,412,21,433,2,2,4,4,4,5
"Region7","retail","Retail Store","July",10,4,4,2,5,13,413,433,18,20,426,25,451,5,3,4,3,4,4
"Region7","retail","Retail Store","August",11,3,3,3,4,15,373,393,19,20,388,24,412,3,4,3,5,5,3
"Region7","retail","Retail Store","September",11,4,2,3,4,10,373,393,14,20,383,24,407,3,3,4,4,3,5
"Region7","retail","Retail Store","October",13,4,3,3,2,14,364,387,16,23,378,25,403,5,3,3,3,2,3
"Region7","retail","Retail Store","November",13,4,4,3,2,11,476,500,13,24,487,26,513,2,4,4,4,2,4
"Region7","retail","Kirana Store","January",12,3,5,4,4,12,393,417,16,24,405,28,433,2,3,2,3,4,3
"Region7","retail","Kirana Store","February",10,4,5,3,2,14,347,369,16,22,361,24,385,4,3,3,5,3,2
"Region7","retail","Kirana Store","March",12,3,4,4,3,15,377,400,18,23,392,26,418,3,2,5,3,4,5
"Region7","retail","Kirana Store","April",10,4,4,3,5,10,390,411,15,21,400,26,426,3,5,3,3,2,3
"Region7","retail","Kirana Store","May",12,4,3,5,2,12,468,492,14,24,480,26,506,4,4,2,3,3,3
"Region7","retail","Kirana Store","June",11,4,4,4,5,14,484,507,19,23,498,28,526,3,3,3,5,2,3
"Region7","retail","Kirana Store","July",10,3,5,4,3,11,398,420,14,22,409,25,434,5,3,4,3,3,3
"Region7","retail","Kirana Store","August",12,2,4,4,3,10,499,521,13,22,509,25,534,3,3,4,4,2,5
"Region7","retail","Kirana Store","September",10,2,4,4,3,12,457,477,15,20,469,23,492,4,4,2,3,3,2
"Region7","retail","Kirana Store","October",13,5,5,3,2,13,453,479,15,26,466,28,494,2,4,3,3,3,2
"Region7","retail","Kirana Store","November",12,3,3,4,4,12,447,469,16,22,459,26,485,3,2,4,4,3,3
"Region7","retail","Hotels","January",11,2,3,3,4,15,415,434,19,19,430,23,453,3,3,3,3,2,3
"Region7","retail","Hotels","February",10,2,4,4,5,10,373,393,15,20,383,25,408,4,3,4,3,3,4
"Region7","retail","Hotels","March",10,5,5,4,2,15,466,490,17,24,481,26,507,5,4,3,3,3,2
"Region7","retail","Hotels","April",10,4,3,2,2,11,386,405,13,19,397,21,418,4,4,5,4,2,3
"Region7","retail","Hotels","May",12,3,4,2,2,11,372,393,13,21,383,23,406,4,3,5,4,5,4
"Region7","retail","Hotels","June",13,3,3,4,4,13,430,453,17,23,443,27,470,5,2,4,4,3,4
"Region7","retail","Hotels","July",12,3,5,5,3,10,328,353,13,25,338,28,366,4,3,5,2,2,3
"Region7","retail","Hotels","August",11,5,3,2,4,11,325,346,15,21,336,25,361,3,3,4,3,3,4
"Region7","retail","Hotels","September",12,4,3,4,2,10,303,326,12,23,313,25,338,3,4,4,3,3,2
"Region7","retail","Hotels","October",12,3,2,4,2,13,489,510,15,21,502,23,525,4,4,2,4,3,4
"Region7","retail","Hotels","November",10,4,4,5,4,13,341,364,17,23,354,27,381,5,4,5,3,2,3
"Region7","retail","Restaurants","January",11,4,2,4,2,11,356,377,13,21,367,23,390,2,5,2,4,5,4
"Region7","retail","Restaurants","February",11,3,3,4,3,15,478,499,18,21,493,24,517,5,4,2,4,3,4
"Region7","retail","Restaurants","March",12,3,4,5,3,12,476,500,15,24,488,27,515,3,4,2,4,5,4
"Region7","retail","Restaurants","April",12,4,4,2,5,13,419,441,18,22,432,27,459,4,2,3,2,5,4
"Region7","retail","Restaurants","May",12,2,3,3,3,11,341,361,14,20,352,23,375,2,3,4,3,2,2
"Region7","retail","Restaurants","June",13,5,4,4,3,13,314,340,16,26,327,29,356,4,3,3,3,2,5
"Region7","retail","Restaurants","July",11,2,4,5,3,15,334,356,18,22,349,25,374,4,4,3,4,5,4
"Region7","retail","Restaurants","August",10,4,3,4,4,10,447,468,14,21,457,25,482,5,3,4,2,3,2
"Region7","retail","Restaurants","September",12,5,4,5,3,12,486,512,15,26,498,29,527,3,4,2,3,3,5
"Region7","retail","Restaurants","October",13,2,2,3,4,11,480,500,15,20,491,24,515,4,3,5,4,3,4
"Region7","retail","Restaurants","November",10,3,4,4,5,13,391,412,18,21,404,26,430,4,3,2,3,2,3
"Region7","retail","Airline","January",12,3,4,4,2,14,372,395,16,23,386,25,411,4,3,3,2,4,4
"Region7","retail","Airline","February",11,2,3,4,5,13,369,389,18,20,382,25,407,4,4,4,4,4,5
"Region7","retail","Airline","March",12,4,3,4,3,13,434,457,16,23,447,26,473,3,3,3,5,3,5
"Region7","retail","Airline","April",11,3,3,5,2,11,318,340,13,22,329,24,353,2,4,4,3,4,4
"Region7","retail","Airline","May",10,3,2,4,2,15,390,409,17,19,405,21,426,3,4,2,3,4,4
"Region7","retail","Airline","June",11,3,3,5,2,13,401,423,15,22,414,24,438,5,2,2,3,5,4
"Region7","retail","Airline","July",12,4,5,3,5,12,495,519,17,24,507,29,536,2,4,2,4,3,3
"Region7","retail","Airline","August",11,5,5,5,4,15,357,383,19,26,372,30,402,3,2,4,3,4,4
"Region7","retail","Airline","September",13,5,4,2,4,12,461,485,16,24,473,28,501,3,3,5,4,3,2
"Region7","retail","Airline","October",12,5,3,5,4,14,429,454,18,25,443,29,472,4,4,3,3,3,5
"Region7","retail","Airline","November",13,4,5,4,4,15,492,518,19,26,507,30,537,4,3,3,2,4,4
"Region7","retail","Hardware Store","January",11,3,3,2,3,12,493,512,15,19,505,22,527,5,3,3,4,2,5
"Region7","retail","Hardware Store","February",12,3,4,3,3,13,451,473,16,22,464,25,489,4,3,3,3,3,4
"Region7","retail","Hardware Store","March",13,3,3,3,2,10,426,448,12,22,436,24,460,2,4,4,5,4,2
"Region7","retail","Hardware Store","April",11,3,5,3,5,13,339,361,18,22,352,27,379,4,3,3,3,5,5
"Region7","retail","Hardware Store","May",11,3,3,5,4,14,426,448,18,22,440,26,466,3,3,3,5,5,4
"Region7","retail","Hardware Store","June",13,3,4,4,4,14,482,506,18,24,496,28,524,3,5,2,3,3,2
"Region7","retail","Hardware Store","July",12,4,4,3,4,15,384,407,19,23,399,27,426,5,4,4,4,3,3
"Region7","retail","Hardware Store","August",12,3,5,2,5,13,500,522,18,22,513,27,540,4,3,3,3,4,4
"Region7","retail","Hardware Store","September",11,5,3,3,4,11,307,329,15,22,318,26,344,3,4,4,2,3,3
"Region7","retail","Hardware Store","October",11,3,4,4,4,11,476,498,15,22,487,26,513,3,5,5,3,3,4
"Region7","retail","Hardware Store","November",11,2,2,3,5,12,335,353,17,18,347,23,370,4,4,3,4,5,5
"Region7","retail","Computer Store","January",11,2,3,5,3,14,340,361,17,21,354,24,378,3,4,2,4,2,2
"Region7","retail","Computer Store","February",12,5,3,2,3,10,352,374,13,22,362,25,387,5,4,5,4,5,3
"Region7","retail","Computer Store","March",11,4,3,3,3,11,340,361,14,21,351,24,375,2,5,3,4,3,3
"Region7","retail","Computer Store","April",13,5,4,2,2,11,431,455,13,24,442,26,468,4,3,2,3,4,2
"Region7","retail","Computer Store","May",13,3,4,3,3,12,336,359,15,23,348,26,374,4,4,5,4,2,3
"Region7","retail","Computer Store","June",10,5,2,5,2,12,446,468,14,22,458,24,482,3,2,4,4,4,5
"Region7","retail","Computer Store","July",11,4,4,4,3,14,323,346,17,23,337,26,363,4,3,4,3,4,4
"Region7","retail","Computer Store","August",13,4,5,4,3,14,365,391,17,26,379,29,408,2,3,3,3,5,2
"Region7","retail","Computer Store","September",12,2,5,4,4,15,341,364,19,23,356,27,383,4,5,3,5,5,3
"Region7","retail","Computer Store","October",10,4,3,4,3,14,434,455,17,21,448,24,472,3,4,4,3,3,4
"Region7","retail","Computer Store","November",11,5,3,4,3,15,436,459,18,23,451,26,477,3,4,3,4,4,3
"Region7","retail","Gaming Zone","January",12,4,3,2,4,14,321,342,18,21,335,25,360,5,5,2,4,4,4
"Region7","retail","Gaming Zone","February",10,3,5,5,3,14,493,516,17,23,507,26,533,2,4,3,2,4,5
"Region7","retail","Gaming Zone","March",12,4,3,4,5,10,486,509,15,23,496,28,524,4,4,4,3,3,3
"Region7","retail","Gaming Zone","April",12,3,4,4,4,15,391,414,19,23,406,27,433,4,3,4,4,5,5
"Region7","retail","Gaming Zone","May",11,5,5,4,3,11,419,444,14,25,430,28,458,5,2,3,2,3,4
"Region7","retail","Gaming Zone","June",11,4,4,4,3,14,381,404,17,23,395,26,421,4,5,2,3,4,4
"Region7","retail","Gaming Zone","July",11,4,3,5,4,13,386,409,17,23,399,27,426,3,4,4,4,3,5
"Region7","retail","Gaming Zone","August",10,5,5,3,4,12,381,404,16,23,393,27,420,3,4,2,4,2,4
"Region7","retail","Gaming Zone","September",12,3,4,3,4,12,484,506,16,22,496,26,522,2,4,5,2,5,3
"Region7","retail","Gaming Zone","October",13,4,4,4,3,13,346,371,16,25,359,28,387,5,3,4,3,5,4
"Region7","retail","Gaming Zone","November",11,3,5,5,4,11,342,366,15,24,353,28,381,3,4,5,2,5,3
"Region7","retail","Super MArket","January",10,3,4,3,2,11,477,497,13,20,488,22,510,3,4,4,3,3,3
"Region7","retail","Super MArket","February",13,5,4,3,2,14,336,361,16,25,350,27,377,3,3,3,2,3,5
"Region7","retail","Super MArket","March",11,3,3,3,2,14,313,333,16,20,327,22,349,3,5,3,4,2,4
"Region7","retail","Super MArket","April",11,4,3,3,3,15,405,426,18,21,420,24,444,2,3,4,5,4,2
"Region7","retail","Super MArket","May",11,5,4,2,5,12,354,376,17,22,366,27,393,5,4,3,3,3,2
"Region7","retail","Super MArket","June",10,5,3,3,4,13,303,324,17,21,316,25,341,4,4,4,3,3,4
"Region7","retail","Super MArket","July",12,4,3,4,4,11,419,442,15,23,430,27,457,2,5,3,4,4,4
"Region7","retail","Super MArket","August",12,5,3,4,5,11,435,459,16,24,446,29,475,3,3,4,3,4,5
"Region7","retail","Super MArket","September",11,4,3,3,4,11,486,507,15,21,497,25,522,2,3,3,2,3,5
"Region7","retail","Super MArket","October",11,3,4,3,3,15,361,382,18,21,376,24,400,3,4,2,4,3,5
"Region7","retail","Super MArket","November",13,2,3,3,4,14,433,454,18,21,447,25,472,3,4,4,3,3,3
"Region7","retail","Fast Food Centre","January",11,4,2,4,5,14,372,393,19,21,386,26,412,3,4,4,5,3,4
"Region7","retail","Fast Food Centre","February",10,5,4,4,4,12,492,515,16,23,504,27,531,2,4,3,5,3,3
"Region7","retail","Fast Food Centre","March",10,4,2,4,4,12,496,516,16,20,508,24,532,2,3,3,4,5,5
"Region7","retail","Fast Food Centre","April",13,4,2,4,3,11,413,436,14,23,424,26,450,2,3,3,2,3,3
"Region7","retail","Fast Food Centre","May",11,4,5,4,4,13,474,498,17,24,487,28,515,5,3,3,4,3,4
"Region7","retail","Fast Food Centre","June",10,4,3,3,2,10,306,326,12,20,316,22,338,3,4,3,5,4,5
"Region7","retail","Fast Food Centre","July",13,2,4,3,5,10,352,374,15,22,362,27,389,3,4,4,4,3,4
"Region7","retail","Fast Food Centre","August",11,4,4,3,5,13,337,359,18,22,350,27,377,5,3,4,3,3,2
"Region7","retail","Fast Food Centre","September",12,4,3,4,3,15,416,439,18,23,431,26,457,4,5,4,4,4,5
"Region7","retail","Fast Food Centre","October",10,3,4,3,3,14,400,420,17,20,414,23,437,2,3,2,4,5,5
"Region7","retail","Fast Food Centre","November",12,3,2,2,4,14,483,502,18,19,497,23,520,3,3,2,4,3,3
"Region7","holding","Retail Store","January",11,4,5,3,3,11,333,356,14,23,344,26,370,3,4,4,3,2,2
"Region7","holding","Retail Store","February",12,5,4,3,3,14,333,357,17,24,347,27,374,2,4,3,2,5,3
"Region7","holding","Retail Store","March",11,3,4,3,3,14,421,442,17,21,435,24,459,5,2,3,3,4,4
"Region7","holding","Retail Store","April",11,2,4,2,3,15,343,362,18,19,358,22,380,5,2,4,5,4,3
"Region7","holding","Retail Store","May",12,4,4,5,3,11,406,431,14,25,417,28,445,4,4,4,4,3,3
"Region7","holding","Retail Store","June",12,2,5,3,4,13,303,325,17,22,316,26,342,4,4,5,3,3,5
"Region7","holding","Retail Store","July",13,3,3,4,3,10,354,377,13,23,364,26,390,4,3,3,4,5,2
"Region7","holding","Retail Store","August",12,4,2,2,2,11,445,465,13,20,456,22,478,4,4,4,4,4,4
"Region7","holding","Retail Store","September",12,3,4,4,3,12,453,476,15,23,465,26,491,5,2,3,2,2,2
"Region7","holding","Retail Store","October",10,2,3,3,3,11,343,361,14,18,354,21,375,5,3,3,5,3,2
"Region7","holding","Retail Store","November",13,4,3,4,2,12,445,469,14,24,457,26,483,5,4,4,2,3,3
"Region7","holding","Kirana Store","January",12,4,3,3,4,12,355,377,16,22,367,26,393,5,4,3,4,3,4
"Region7","holding","Kirana Store","February",11,2,4,3,3,13,418,438,16,20,431,23,454,5,3,3,4,3,2
"Region7","holding","Kirana Store","March",11,3,3,5,5,12,399,421,17,22,411,27,438,3,5,4,4,4,4
"Region7","holding","Kirana Store","April",11,3,3,2,3,10,499,518,13,19,509,22,531,5,4,4,4,4,2
"Region7","holding","Kirana Store","May",10,5,5,4,3,10,372,396,13,24,382,27,409,4,3,2,5,3,4
"Region7","holding","Kirana Store","June",11,2,4,2,4,10,324,343,14,19,334,23,357,4,4,2,3,4,4
"Region7","holding","Kirana Store","July",12,4,3,4,3,13,368,391,16,23,381,26,407,3,3,5,3,3,3
"Region7","holding","Kirana Store","August",13,2,3,2,3,14,410,430,17,20,424,23,447,4,3,5,3,3,5
"Region7","holding","Kirana Store","September",13,3,4,4,3,14,336,360,17,24,350,27,377,4,4,4,2,4,3
"Region7","holding","Kirana Store","October",11,4,5,5,2,11,479,504,13,25,490,27,517,2,3,2,4,4,5
"Region7","holding","Kirana Store","November",12,3,5,3,4,10,402,425,14,23,412,27,439,4,4,4,4,5,3
"Region7","holding","Hotels","January",11,3,5,4,5,14,473,496,19,23,487,28,515,3,4,4,4,4,5
"Region7","holding","Hotels","February",11,3,3,3,3,10,369,389,13,20,379,23,402,2,4,3,2,5,3
"Region7","holding","Hotels","March",10,3,3,2,4,15,494,512,19,18,509,22,531,2,5,2,3,5,4
"Region7","holding","Hotels","April",13,5,3,3,5,12,494,518,17,24,506,29,535,3,3,2,3,2,2
"Region7","holding","Hotels","May",11,4,5,5,5,13,491,516,18,25,504,30,534,5,3,3,3,4,4
"Region7","holding","Hotels","June",13,5,3,2,2,14,396,419,16,23,410,25,435,3,3,3,2,5,5
"Region7","holding","Hotels","July",13,2,5,2,5,15,329,351,20,22,344,27,371,4,4,3,3,3,3
"Region7","holding","Hotels","August",10,3,3,4,2,15,339,359,17,20,354,22,376,4,3,5,3,5,4
"Region7","holding","Hotels","September",11,3,3,4,2,11,346,367,13,21,357,23,380,4,3,4,5,3,3
"Region7","holding","Hotels","October",11,5,3,4,3,11,433,456,14,23,444,26,470,5,4,3,4,2,4
"Region7","holding","Hotels","November",11,4,5,4,4,12,483,507,16,24,495,28,523,2,5,3,3,4,4
"Region7","holding","Restaurants","January",13,4,4,2,4,11,496,519,15,23,507,27,534,3,3,4,3,3,3
"Region7","holding","Restaurants","February",11,3,5,2,3,12,332,353,15,21,344,24,368,3,2,4,3,2,4
"Region7","holding","Restaurants","March",11,3,5,5,4,15,350,374,19,24,365,28,393,4,5,2,2,3,3
"Region7","holding","Restaurants","April",11,4,4,3,2,10,345,367,12,22,355,24,379,3,4,4,3,4,4
"Region7","holding","Restaurants","May",13,2,5,4,4,12,481,505,16,24,493,28,521,4,5,2,3,2,5
"Region7","holding","Restaurants","June",10,5,2,3,3,14,424,444,17,20,438,23,461,4,3,5,4,3,2
"Region7","holding","Restaurants","July",13,4,2,3,3,14,385,407,17,22,399,25,424,4,4,3,3,4,4
"Region7","holding","Restaurants","August",13,2,4,3,4,12,334,356,16,22,346,26,372,4,5,3,4,2,4
"Region7","holding","Restaurants","September",12,4,3,4,5,13,429,452,18,23,442,28,470,5,2,5,4,4,4
"Region7","holding","Restaurants","October",12,3,5,4,4,15,442,466,19,24,457,28,485,3,5,3,3,5,2
"Region7","holding","Restaurants","November",11,4,2,4,4,12,337,358,16,21,349,25,374,4,4,3,2,3,3
"Region7","holding","Airline","January",11,2,2,3,5,15,335,353,20,18,350,23,373,4,4,3,4,2,4
"Region7","holding","Airline","February",10,4,4,4,3,11,405,427,14,22,416,25,441,4,5,3,3,3,3
"Region7","holding","Airline","March",12,4,2,4,3,11,352,374,14,22,363,25,388,2,3,4,5,4,4
"Region7","holding","Airline","April",12,2,4,4,5,10,449,471,15,22,459,27,486,2,4,4,4,5,3
"Region7","holding","Airline","May",10,2,4,2,4,11,468,486,15,18,479,22,501,5,4,3,3,3,3
"Region7","holding","Airline","June",12,4,4,2,4,11,390,412,15,22,401,26,427,3,4,3,5,3,3
"Region7","holding","Airline","July",12,5,2,5,5,14,325,349,19,24,339,29,368,2,3,5,4,5,4
"Region7","holding","Airline","August",11,2,2,4,2,12,394,413,14,19,406,21,427,4,4,5,4,4,3
"Region7","holding","Airline","September",10,5,4,4,5,10,471,494,15,23,481,28,509,3,5,4,4,5,4
"Region7","holding","Airline","October",12,5,4,4,3,13,346,371,16,25,359,28,387,4,3,3,3,2,3
"Region7","holding","Airline","November",11,5,2,2,4,13,436,456,17,20,449,24,473,4,4,3,5,3,2
"Region7","holding","Hardware Store","January",12,3,4,4,4,12,354,377,16,23,366,27,393,4,4,4,3,4,4
"Region7","holding","Hardware Store","February",11,2,5,3,4,13,388,409,17,21,401,25,426,4,3,4,4,4,5
"Region7","holding","Hardware Store","March",11,2,4,4,2,14,496,517,16,21,510,23,533,4,3,4,4,2,3
"Region7","holding","Hardware Store","April",13,3,3,3,3,12,365,387,15,22,377,25,402,2,3,4,4,4,4
"Region7","holding","Hardware Store","May",11,2,3,3,4,10,422,441,14,19,432,23,455,4,3,4,4,3,4
"Region7","holding","Hardware Store","June",13,5,3,4,3,14,499,524,17,25,513,28,541,4,4,5,2,4,3
"Region7","holding","Hardware Store","July",11,5,4,3,2,10,476,499,12,23,486,25,511,5,3,3,3,5,2
"Region7","holding","Hardware Store","August",10,3,2,3,4,11,354,372,15,18,365,22,387,2,2,5,3,4,4
"Region7","holding","Hardware Store","September",10,4,3,2,2,12,384,403,14,19,396,21,417,4,4,3,3,3,3
"Region7","holding","Hardware Store","October",12,4,4,4,2,15,346,370,17,24,361,26,387,4,4,4,5,4,2
"Region7","holding","Hardware Store","November",13,4,4,3,5,14,469,493,19,24,483,29,512,2,4,3,5,5,2
"Region7","holding","Computer Store","January",11,4,3,2,3,15,473,493,18,20,488,23,511,4,5,4,3,4,2
"Region7","holding","Computer Store","February",12,3,4,3,4,10,372,394,14,22,382,26,408,4,5,2,3,3,4
"Region7","holding","Computer Store","March",12,3,3,3,2,14,306,327,16,21,320,23,343,2,3,4,4,3,5
"Region7","holding","Computer Store","April",12,4,3,4,3,10,354,377,13,23,364,26,390,4,4,3,2,5,5
"Region7","holding","Computer Store","May",13,4,4,5,5,10,331,357,15,26,341,31,372,4,3,4,4,5,4
"Region7","holding","Computer Store","June",12,3,3,3,4,10,373,394,14,21,383,25,408,5,3,4,3,3,5
"Region7","holding","Computer Store","July",12,3,3,3,3,14,415,436,17,21,429,24,453,3,5,5,3,4,2
"Region7","holding","Computer Store","August",11,4,3,3,3,13,349,370,16,21,362,24,386,3,4,3,3,5,3
"Region7","holding","Computer Store","September",11,4,2,4,3,11,304,325,14,21,315,24,339,3,3,3,4,2,3
"Region7","holding","Computer Store","October",10,4,5,3,4,14,496,518,18,22,510,26,536,2,5,3,4,5,4
"Region7","holding","Computer Store","November",11,4,5,3,3,13,453,476,16,23,466,26,492,5,2,2,4,4,3
"Region7","holding","Gaming Zone","January",11,4,3,3,2,15,489,510,17,21,504,23,527,4,5,4,4,4,5
"Region7","holding","Gaming Zone","February",12,3,2,5,5,13,415,437,18,22,428,27,455,5,5,3,2,4,5
"Region7","holding","Gaming Zone","March",10,4,4,4,4,13,477,499,17,22,490,26,516,2,4,4,4,4,3
"Region7","holding","Gaming Zone","April",13,2,5,3,4,12,491,514,16,23,503,27,530,2,4,4,4,4,3
"Region7","holding","Gaming Zone","May",12,2,3,3,3,11,420,440,14,20,431,23,454,3,3,2,4,3,4
"Region7","holding","Gaming Zone","June",11,3,3,4,5,13,479,500,18,21,492,26,518,3,4,3,3,3,5
"Region7","holding","Gaming Zone","July",11,4,5,4,3,14,325,349,17,24,339,27,366,4,5,3,4,2,3
"Region7","holding","Gaming Zone","August",11,3,4,4,5,12,463,485,17,22,475,27,502,2,3,3,3,3,3
"Region7","holding","Gaming Zone","September",12,3,3,4,2,14,411,433,16,22,425,24,449,4,3,3,3,5,5
"Region7","holding","Gaming Zone","October",10,5,2,3,4,11,422,442,15,20,433,24,457,3,2,2,5,2,5
"Region7","holding","Gaming Zone","November",12,2,4,4,3,13,355,377,16,22,368,25,393,3,4,3,5,4,5
"Region7","holding","Super MArket","January",12,3,2,5,3,14,390,412,17,22,404,25,429,3,5,2,5,5,3
"Region7","holding","Super MArket","February",12,3,4,4,4,10,353,376,14,23,363,27,390,4,3,5,2,4,3
"Region7","holding","Super MArket","March",13,3,4,2,3,13,400,422,16,22,413,25,438,3,2,2,4,2,4
"Region7","holding","Super MArket","April",11,3,4,5,3,13,402,425,16,23,415,26,441,3,5,4,5,4,3
"Region7","holding","Super MArket","May",13,4,4,4,4,13,333,358,17,25,346,29,375,4,5,2,3,3,5
"Region7","holding","Super MArket","June",13,5,2,2,3,13,401,423,16,22,414,25,439,5,3,3,4,4,4
"Region7","holding","Super MArket","July",13,4,3,4,3,13,303,327,16,24,316,27,343,4,2,4,3,5,3
"Region7","holding","Super MArket","August",11,3,4,4,3,12,349,371,15,22,361,25,386,3,3,3,4,3,3
"Region7","holding","Super MArket","September",11,4,4,5,5,13,498,522,18,24,511,29,540,3,3,4,4,4,3
"Region7","holding","Super MArket","October",10,2,2,3,5,13,362,379,18,17,375,22,397,4,2,4,2,2,5
"Region7","holding","Super MArket","November",12,4,3,5,4,13,399,423,17,24,412,28,440,3,2,4,5,4,3
"Region7","holding","Fast Food Centre","January",11,3,4,5,4,11,480,503,15,23,491,27,518,3,3,4,4,5,5
"Region7","holding","Fast Food Centre","February",11,4,3,3,5,13,415,436,18,21,428,26,454,5,3,5,4,3,5
"Region7","holding","Fast Food Centre","March",12,3,2,2,4,14,452,471,18,19,466,23,489,4,3,3,3,4,2
"Region7","holding","Fast Food Centre","April",13,4,3,2,3,10,341,363,13,22,351,25,376,4,2,5,5,5,3
"Region7","holding","Fast Food Centre","May",11,2,4,2,3,11,367,386,14,19,378,22,400,4,4,3,4,5,4
"Region7","holding","Fast Food Centre","June",12,3,2,5,4,11,359,381,15,22,370,26,396,4,3,3,4,2,5
"Region7","holding","Fast Food Centre","July",11,3,4,3,4,11,336,357,15,21,347,25,372,5,3,2,3,4,3
"Region7","holding","Fast Food Centre","August",11,4,3,5,5,12,380,403,17,23,392,28,420,2,5,2,3,2,4
"Region7","holding","Fast Food Centre","September",11,3,4,5,5,12,327,350,17,23,339,28,367,5,2,2,4,5,4
"Region7","holding","Fast Food Centre","October",12,2,3,2,4,11,499,518,15,19,510,23,533,5,4,5,5,3,4
"Region7","holding","Fast Food Centre","November",12,4,5,4,3,11,352,377,14,25,363,28,391,3,5,3,3,4,4
"Region8","retail","Retail Store","January",12,4,3,5,4,14,320,344,18,24,334,28,362,4,2,4,3,4,5
"Region8","retail","Retail Store","February",10,3,2,3,5,12,424,442,17,18,436,23,459,3,4,3,2,3,3
"Region8","retail","Retail Store","March",13,5,4,4,5,15,303,329,20,26,318,31,349,5,4,4,4,4,5
"Region8","retail","Retail Store","April",11,3,5,4,2,10,393,416,12,23,403,25,428,4,2,3,2,3,5
"Region8","retail","Retail Store","May",12,2,3,3,5,11,455,475,16,20,466,25,491,4,4,5,2,2,3
"Region8","retail","Retail Store","June",10,3,5,4,4,12,335,357,16,22,347,26,373,2,4,4,3,4,5
"Region8","retail","Retail Store","July",11,5,4,3,5,15,487,510,20,23,502,28,530,3,4,2,5,3,5
"Region8","retail","Retail Store","August",11,4,3,4,4,12,363,385,16,22,375,26,401,5,3,5,4,5,4
"Region8","retail","Retail Store","September",11,4,5,3,5,14,486,509,19,23,500,28,528,4,5,5,2,2,5
"Region8","retail","Retail Store","October",13,3,2,3,3,12,445,466,15,21,457,24,481,4,4,3,4,4,3
"Region8","retail","Retail Store","November",11,4,4,4,4,13,352,375,17,23,365,27,392,4,2,4,3,3,2
"Region8","retail","Kirana Store","January",10,4,3,2,3,11,440,459,14,19,451,22,473,4,4,3,3,4,3
"Region8","retail","Kirana Store","February",13,3,2,3,3,15,304,325,18,21,319,24,343,5,3,3,4,3,4
"Region8","retail","Kirana Store","March",11,3,4,4,2,13,376,398,15,22,389,24,413,5,5,4,4,5,3
"Region8","retail","Kirana Store","April",13,3,4,3,4,13,387,410,17,23,400,27,427,3,2,4,3,3,3
"Region8","retail","Kirana Store","May",11,5,5,3,3,15,362,386,18,24,377,27,404,5,3,2,5,5,3
"Region8","retail","Kirana Store","June",10,3,4,3,5,11,306,326,16,20,317,25,342,3,2,5,3,4,3
"Region8","retail","Kirana Store","July",12,4,5,3,4,13,320,344,17,24,333,28,361,4,5,3,3,4,5
"Region8","retail","Kirana Store","August",11,2,4,5,3,11,433,455,14,22,444,25,469,3,5,2,4,3,3
"Region8","retail","Kirana Store","September",11,3,2,3,4,13,492,511,17,19,505,23,528,3,4,4,3,4,3
"Region8","retail","Kirana Store","October",11,5,4,4,2,13,312,336,15,24,325,26,351,3,4,3,3,4,3
"Region8","retail","Kirana Store","November",12,4,4,3,3,15,400,423,18,23,415,26,441,4,3,3,5,3,3
"Region8","retail","Hotels","January",13,5,3,4,5,12,465,490,17,25,477,30,507,3,4,4,5,3,4
"Region8","retail","Hotels","February",10,2,3,4,3,12,375,394,15,19,387,22,409,3,3,4,4,3,4
"Region8","retail","Hotels","March",10,4,4,2,2,15,460,480,17,20,475,22,497,5,3,4,4,5,4
"Region8","retail","Hotels","April",11,4,4,4,2,11,435,458,13,23,446,25,471,3,4,5,3,3,4
"Region8","retail","Hotels","May",11,3,4,4,4,14,476,498,18,22,490,26,516,4,5,5,5,3,3
"Region8","retail","Hotels","June",13,5,3,5,3,11,474,500,14,26,485,29,514,4,3,4,5,3,3
"Region8","retail","Hotels","July",12,2,4,4,4,11,492,514,15,22,503,26,529,2,3,4,2,3,4
"Region8","retail","Hotels","August",13,2,4,3,3,13,378,400,16,22,391,25,416,3,5,5,2,2,4
"Region8","retail","Hotels","September",11,5,4,3,5,15,401,424,20,23,416,28,444,4,5,2,4,3,4
"Region8","retail","Hotels","October",11,4,3,2,4,11,301,321,15,20,312,24,336,4,2,3,4,5,3
"Region8","retail","Hotels","November",11,4,2,4,5,13,364,385,18,21,377,26,403,3,3,3,4,3,5
"Region8","retail","Restaurants","January",12,3,4,4,5,11,366,389,16,23,377,28,405,4,5,4,3,2,4
"Region8","retail","Restaurants","February",11,4,4,5,3,13,419,443,16,24,432,27,459,4,2,3,5,3,4
"Region8","retail","Restaurants","March",13,4,5,4,3,11,368,394,14,26,379,29,408,5,4,4,3,3,4
"Region8","retail","Restaurants","April",12,5,3,5,3,13,491,516,16,25,504,28,532,4,4,3,3,2,5
"Region8","retail","Restaurants","May",11,4,2,5,2,10,452,474,12,22,462,24,486,5,2,3,4,4,3
"Region8","retail","Restaurants","June",11,2,2,4,3,15,318,337,18,19,333,22,355,4,2,4,3,4,2
"Region8","retail","Restaurants","July",12,4,2,2,3,15,485,505,18,20,500,23,523,4,4,3,3,4,4
"Region8","retail","Restaurants","August",11,2,4,3,5,13,431,451,18,20,444,25,469,2,4,2,2,5,2
"Region8","retail","Restaurants","September",12,2,4,4,3,10,343,365,13,22,353,25,378,3,4,2,2,4,3
"Region8","retail","Restaurants","October",11,4,3,3,3,11,321,342,14,21,332,24,356,3,2,3,4,5,5
"Region8","retail","Restaurants","November",11,4,4,2,3,14,334,355,17,21,348,24,372,4,3,2,5,4,3
"Region8","retail","Airline","January",10,4,4,4,4,15,483,505,19,22,498,26,524,4,4,4,3,4,5
"Region8","retail","Airline","February",12,3,5,4,3,12,396,420,15,24,408,27,435,4,4,3,2,2,3
"Region8","retail","Airline","March",13,5,3,2,4,11,324,347,15,23,335,27,362,2,3,3,4,2,3
"Region8","retail","Airline","April",12,2,4,3,2,11,383,404,13,21,394,23,417,3,2,3,3,3,3
"Region8","retail","Airline","May",13,4,4,4,3,12,370,395,15,25,382,28,410,2,2,3,5,4,2
"Region8","retail","Airline","June",12,5,2,5,4,13,459,483,17,24,472,28,500,4,4,2,2,4,4
"Region8","retail","Airline","July",11,3,3,2,2,13,360,379,15,19,373,21,394,5,4,3,4,5,5
"Region8","retail","Airline","August",11,3,2,4,5,10,466,486,15,20,476,25,501,4,3,3,4,3,2
"Region8","retail","Airline","September",12,3,4,5,4,12,325,349,16,24,337,28,365,2,5,3,4,3,2
"Region8","retail","Airline","October",11,2,4,4,3,11,334,355,14,21,345,24,369,3,4,3,2,3,5
"Region8","retail","Airline","November",12,4,3,2,3,14,380,401,17,21,394,24,418,3,2,5,5,4,3
"Region8","retail","Hardware Store","January",12,4,4,5,3,13,362,387,16,25,375,28,403,4,4,4,3,5,4
"Region8","retail","Hardware Store","February",13,4,3,3,4,13,352,375,17,23,365,27,392,4,5,4,4,4,2
"Region8","retail","Hardware Store","March",10,2,4,3,3,11,422,441,14,19,433,22,455,4,3,2,3,5,4
"Region8","retail","Hardware Store","April",11,3,4,5,3,12,376,399,15,23,388,26,414,2,5,4,4,2,3
"Region8","retail","Hardware Store","May",12,5,4,3,2,14,494,518,16,24,508,26,534,4,2,5,5,5,4
"Region8","retail","Hardware Store","June",11,5,2,3,4,13,435,456,17,21,448,25,473,2,2,4,3,5,5
"Region8","retail","Hardware Store","July",11,2,3,3,5,12,443,462,17,19,455,24,479,2,4,4,5,4,4
"Region8","retail","Hardware Store","August",11,3,4,4,4,14,474,496,18,22,488,26,514,3,5,5,4,2,4
"Region8","retail","Hardware Store","September",11,3,4,2,3,12,314,334,15,20,326,23,349,4,2,4,4,3,5
"Region8","retail","Hardware Store","October",11,5,3,3,5,12,438,460,17,22,450,27,477,2,4,3,3,4,3
"Region8","retail","Hardware Store","November",10,2,4,5,4,12,453,474,16,21,465,25,490,5,4,4,4,3,4
"Region8","retail","Computer Store","January",10,4,3,3,5,13,349,369,18,20,362,25,387,3,4,3,4,2,4
"Region8","retail","Computer Store","February",10,5,4,2,5,11,390,411,16,21,401,26,427,2,2,3,3,3,2
"Region8","retail","Computer Store","March",13,3,5,4,5,15,383,408,20,25,398,30,428,4,5,5,2,2,3
"Region8","retail","Computer Store","April",12,3,4,2,5,15,414,435,20,21,429,26,455,4,5,4,3,3,3
"Region8","retail","Computer Store","May",12,3,3,2,3,15,476,496,18,20,491,23,514,2,4,3,5,2,3
"Region8","retail","Computer Store","June",11,4,3,3,3,11,307,328,14,21,318,24,342,3,4,4,3,4,2
"Region8","retail","Computer Store","July",12,3,4,5,4,14,337,361,18,24,351,28,379,3,3,3,5,3,3
"Region8","retail","Computer Store","August",11,4,5,3,4,12,348,371,16,23,360,27,387,2,4,4,4,4,2
"Region8","retail","Computer Store","September",11,4,2,5,5,12,479,501,17,22,491,27,518,2,5,5,4,3,5
"Region8","retail","Computer Store","October",11,4,2,4,2,13,486,507,15,21,499,23,522,4,4,2,5,2,3
"Region8","retail","Computer Store","November",13,3,3,3,4,12,400,422,16,22,412,26,438,3,4,3,3,5,3
"Region8","retail","Gaming Zone","January",11,5,3,4,5,14,342,365,19,23,356,28,384,5,2,4,4,3,4
"Region8","retail","Gaming Zone","February",13,4,5,2,3,15,331,355,18,24,346,27,373,2,4,4,4,4,5
"Region8","retail","Gaming Zone","March",12,4,4,3,4,10,343,366,14,23,353,27,380,5,4,4,5,2,3
"Region8","retail","Gaming Zone","April",12,3,4,5,2,12,400,424,14,24,412,26,438,3,3,4,4,4,5
"Region8","retail","Gaming Zone","May",10,2,3,3,3,14,321,339,17,18,335,21,356,4,5,3,3,4,3
"Region8","retail","Gaming Zone","June",13,4,3,4,3,12,422,446,15,24,434,27,461,5,4,5,2,3,4
"Region8","retail","Gaming Zone","July",11,4,5,5,2,11,448,473,13,25,459,27,486,4,5,4,3,2,5
"Region8","retail","Gaming Zone","August",12,4,4,4,2,13,304,328,15,24,317,26,343,2,4,3,3,3,4
"Region8","retail","Gaming Zone","September",10,2,2,5,4,10,330,349,14,19,340,23,363,4,3,3,5,3,5
"Region8","retail","Gaming Zone","October",11,2,3,5,4,12,353,374,16,21,365,25,390,4,3,2,2,3,5
"Region8","retail","Gaming Zone","November",11,3,4,4,5,15,456,478,20,22,471,27,498,2,4,2,4,3,2
"Region8","retail","Super MArket","January",12,5,2,2,4,14,301,322,18,21,315,25,340,2,2,3,5,4,4
"Region8","retail","Super MArket","February",11,2,3,3,5,13,322,341,18,19,335,24,359,3,4,4,3,3,2
"Region8","retail","Super MArket","March",12,4,4,3,4,13,416,439,17,23,429,27,456,3,5,4,5,5,4
"Region8","retail","Super MArket","April",11,3,3,3,3,12,492,512,15,20,504,23,527,2,5,4,4,4,2
"Region8","retail","Super MArket","May",12,5,3,5,3,12,479,504,15,25,491,28,519,4,3,4,5,4,2
"Region8","retail","Super MArket","June",13,4,4,3,4,14,330,354,18,24,344,28,372,3,5,5,3,5,5
"Region8","retail","Super MArket","July",12,5,5,3,4,13,454,479,17,25,467,29,496,3,3,2,5,5,4
"Region8","retail","Super MArket","August",11,4,5,3,3,14,404,427,17,23,418,26,444,5,4,3,2,4,3
"Region8","retail","Super MArket","September",11,5,2,5,2,10,472,495,12,23,482,25,507,2,4,5,4,5,3
"Region8","retail","Super MArket","October",13,4,3,3,3,12,435,458,15,23,447,26,473,5,4,4,3,3,2
"Region8","retail","Super MArket","November",11,3,4,4,3,11,316,338,14,22,327,25,352,2,2,4,3,4,3
"Region8","retail","Fast Food Centre","January",13,3,3,2,4,10,307,328,14,21,317,25,342,4,4,4,3,4,2
"Region8","retail","Fast Food Centre","February",12,5,4,2,4,15,334,357,19,23,349,27,376,3,3,3,5,2,3
"Region8","retail","Fast Food Centre","March",10,4,2,3,4,14,358,377,18,19,372,23,395,3,4,3,3,3,2
"Region8","retail","Fast Food Centre","April",10,5,4,2,2,11,320,341,13,21,331,23,354,5,4,3,5,3,4
"Region8","retail","Fast Food Centre","May",11,5,3,3,4,11,336,358,15,22,347,26,373,2,2,4,3,4,4
"Region8","retail","Fast Food Centre","June",13,4,3,3,3,13,497,520,16,23,510,26,536,3,4,3,3,2,3
"Region8","retail","Fast Food Centre","July",11,4,2,2,3,15,422,441,18,19,437,22,459,4,4,3,4,3,4
"Region8","retail","Fast Food Centre","August",11,3,3,2,5,10,335,354,15,19,345,24,369,4,4,3,4,4,2
"Region8","retail","Fast Food Centre","September",11,4,3,3,2,13,441,462,15,21,454,23,477,3,3,5,4,3,3
"Region8","retail","Fast Food Centre","October",11,5,3,4,3,11,343,366,14,23,354,26,380,4,5,2,5,3,4
"Region8","retail","Fast Food Centre","November",12,4,2,4,3,14,458,480,17,22,472,25,497,3,4,5,3,5,4
"Region8","holding","Retail Store","January",11,3,4,4,3,11,469,491,14,22,480,25,505,3,4,4,2,3,4
"Region8","holding","Retail Store","February",10,4,4,3,3,12,457,478,15,21,469,24,493,3,2,4,3,3,4
"Region8","holding","Retail Store","March",12,3,4,4,5,11,492,515,16,23,503,28,531,2,5,2,2,3,2
"Region8","holding","Retail Store","April",11,4,5,4,2,10,323,347,12,24,333,26,359,4,4,4,3,3,4
"Region8","holding","Retail Store","May",13,4,3,2,4,11,484,506,15,22,495,26,521,5,2,4,3,4,4
"Region8","holding","Retail Store","June",13,2,4,4,2,14,392,415,16,23,406,25,431,4,4,5,3,2,3
"Region8","holding","Retail Store","July",10,2,3,3,4,10,457,475,14,18,467,22,489,3,4,3,4,5,4
"Region8","holding","Retail Store","August",11,5,3,5,3,14,379,403,17,24,393,27,420,4,2,4,4,2,5
"Region8","holding","Retail Store","September",10,4,3,3,4,14,499,519,18,20,513,24,537,3,5,3,3,3,4
"Region8","holding","Retail Store","October",11,3,5,4,3,11,379,402,14,23,390,26,416,4,3,3,2,3,2
"Region8","holding","Retail Store","November",11,4,4,5,4,14,446,470,18,24,460,28,488,3,4,3,3,5,3
"Region8","holding","Kirana Store","January",10,3,4,4,3,13,300,321,16,21,313,24,337,3,4,3,3,3,4
"Region8","holding","Kirana Store","February",10,3,5,4,3,12,425,447,15,22,437,25,462,2,3,4,2,4,3
"Region8","holding","Kirana Store","March",12,3,2,4,2,11,403,424,13,21,414,23,437,4,4,4,4,5,3
"Region8","holding","Kirana Store","April",13,4,4,3,4,13,438,462,17,24,451,28,479,4,2,2,4,5,4
"Region8","holding","Kirana Store","May",12,4,4,4,4,13,431,455,17,24,444,28,472,4,3,3,4,3,3
"Region8","holding","Kirana Store","June",13,2,4,5,3,14,304,328,17,24,318,27,345,3,3,3,4,2,4
"Region8","holding","Kirana Store","July",13,3,3,2,2,15,389,410,17,21,404,23,427,5,3,2,3,3,5
"Region8","holding","Kirana Store","August",10,4,3,3,5,13,419,439,18,20,432,25,457,3,3,3,4,3,4
"Region8","holding","Kirana Store","September",11,2,4,4,3,11,491,512,14,21,502,24,526,2,5,4,2,4,5
"Region8","holding","Kirana Store","October",13,2,3,3,2,12,301,322,14,21,313,23,336,4,4,4,2,3,5
"Region8","holding","Kirana Store","November",12,5,3,2,4,13,349,371,17,22,362,26,388,4,3,4,3,3,3
"Region8","holding","Hotels","January",10,5,5,3,3,11,441,464,14,23,452,26,478,3,4,4,2,4,3
"Region8","holding","Hotels","February",12,4,4,5,3,15,387,412,18,25,402,28,430,4,4,3,4,4,4
"Region8","holding","Hotels","March",12,4,4,5,3,11,341,366,14,25,352,28,380,3,2,4,3,5,3
"Region8","holding","Hotels","April",13,3,3,5,4,13,314,338,17,24,327,28,355,4,5,4,5,5,3
"Region8","holding","Hotels","May",13,2,3,2,4,15,386,406,19,20,401,24,425,3,4,3,3,4,4
"Region8","holding","Hotels","June",10,2,4,3,4,10,477,496,14,19,487,23,510,4,5,5,5,3,2
"Region8","holding","Hotels","July",12,4,4,3,3,13,372,395,16,23,385,26,411,2,3,5,3,5,3
"Region8","holding","Hotels","August",11,4,4,4,4,14,410,433,18,23,424,27,451,4,5,3,3,4,3
"Region8","holding","Hotels","September",13,4,2,4,5,12,350,373,17,23,362,28,390,4,3,3,4,3,4
"Region8","holding","Hotels","October",11,4,5,3,5,11,451,474,16,23,462,28,490,3,4,3,3,3,3
"Region8","holding","Hotels","November",12,3,4,4,4,13,420,443,17,23,433,27,460,5,2,5,3,3,4
"Region8","holding","Restaurants","January",12,5,2,3,4,11,414,436,15,22,425,26,451,5,3,2,4,4,5
"Region8","holding","Restaurants","February",12,4,3,3,5,13,319,341,18,22,332,27,359,4,3,4,3,5,5
"Region8","holding","Restaurants","March",12,3,4,5,3,12,425,449,15,24,437,27,464,5,2,2,4,3,3
"Region8","holding","Restaurants","April",11,4,5,4,3,14,479,503,17,24,493,27,520,4,3,3,2,4,3
"Region8","holding","Restaurants","May",12,4,3,3,3,12,414,436,15,22,426,25,451,3,2,4,2,5,4
"Region8","holding","Restaurants","June",11,4,4,4,4,13,423,446,17,23,436,27,463,5,4,5,4,3,3
"Region8","holding","Restaurants","July",13,5,4,4,4,11,429,455,15,26,440,30,470,4,4,2,5,4,4
"Region8","holding","Restaurants","August",11,2,3,4,3,12,361,381,15,20,373,23,396,2,3,3,4,3,2
"Region8","holding","Restaurants","September",11,3,2,4,2,10,356,376,12,20,366,22,388,3,4,3,4,3,4
"Region8","holding","Restaurants","October",10,3,2,4,4,13,362,381,17,19,375,23,398,2,4,4,3,5,2
"Region8","holding","Restaurants","November",12,4,4,4,4,11,453,477,15,24,464,28,492,3,4,4,3,3,3
"Region8","holding","Airline","January",11,2,3,4,3,10,369,389,13,20,379,23,402,4,3,3,3,4,3
"Region8","holding","Airline","February",13,3,3,2,3,12,488,509,15,21,500,24,524,5,4,4,4,4,4
"Region8","holding","Airline","March",13,5,4,2,2,14,454,478,16,24,468,26,494,3,4,5,3,2,3
"Region8","holding","Airline","April",12,2,3,5,5,14,404,426,19,22,418,27,445,2,2,2,5,4,2
"Region8","holding","Airline","May",10,5,3,4,4,14,350,372,18,22,364,26,390,3,4,4,5,3,5
"Region8","holding","Airline","June",11,3,3,5,3,15,414,436,18,22,429,25,454,3,4,3,4,2,2
"Region8","holding","Airline","July",13,5,5,3,4,12,463,489,16,26,475,30,505,4,3,2,4,5,2
"Region8","holding","Airline","August",10,3,4,2,2,14,437,456,16,19,451,21,472,4,2,5,3,4,4
"Region8","holding","Airline","September",13,3,3,5,5,11,366,390,16,24,377,29,406,4,4,5,4,3,4
"Region8","holding","Airline","October",11,5,2,4,2,12,410,432,14,22,422,24,446,2,2,3,5,3,4
"Region8","holding","Airline","November",11,3,3,4,3,13,373,394,16,21,386,24,410,5,3,4,5,4,3
"Region8","holding","Hardware Store","January",12,4,4,3,3,14,454,477,17,23,468,26,494,4,4,3,5,3,4
"Region8","holding","Hardware Store","February",11,3,3,4,4,12,347,368,16,21,359,25,384,4,4,2,2,3,4
"Region8","holding","Hardware Store","March",10,4,4,3,5,12,306,327,17,21,318,26,344,4,3,5,2,5,5
"Region8","holding","Hardware Store","April",12,4,3,3,5,10,444,466,15,22,454,27,481,2,4,2,5,3,5
"Region8","holding","Hardware Store","May",12,2,2,4,4,10,347,367,14,20,357,24,381,3,3,4,4,4,4
"Region8","holding","Hardware Store","June",12,2,5,4,2,14,434,457,16,23,448,25,473,4,2,2,5,4,5
"Region8","holding","Hardware Store","July",12,4,3,3,5,14,364,386,19,22,378,27,405,5,2,3,2,4,5
"Region8","holding","Hardware Store","August",10,2,2,4,4,11,484,502,15,18,495,22,517,4,3,5,5,2,2
"Region8","holding","Hardware Store","September",11,5,2,2,5,14,340,360,19,20,354,25,379,3,3,4,5,3,3
"Region8","holding","Hardware Store","October",11,4,4,2,5,14,461,482,19,21,475,26,501,2,2,4,5,2,4
"Region8","holding","Hardware Store","November",12,5,2,3,3,11,422,444,14,22,433,25,458,4,3,3,4,4,2
"Region8","holding","Computer Store","January",12,4,5,3,5,14,379,403,19,24,393,29,422,2,5,4,4,5,3
"Region8","holding","Computer Store","February",12,3,3,5,3,11,377,400,14,23,388,26,414,5,2,2,5,2,2
"Region8","holding","Computer Store","March",10,4,4,3,2,13,435,456,15,21,448,23,471,5,5,4,3,5,5
"Region8","holding","Computer Store","April",13,5,2,2,2,12,372,394,14,22,384,24,408,3,5,5,4,3,4
"Region8","holding","Computer Store","May",12,3,4,4,4,12,331,354,16,23,343,27,370,5,2,4,4,3,2
"Region8","holding","Computer Store","June",12,5,4,4,5,11,392,417,16,25,403,30,433,4,5,4,3,5,5
"Region8","holding","Computer Store","July",12,5,4,5,2,12,336,362,14,26,348,28,376,3,2,4,4,4,4
"Region8","holding","Computer Store","August",11,2,3,4,2,14,323,343,16,20,337,22,359,2,4,4,4,5,3
"Region8","holding","Computer Store","September",12,5,2,2,4,11,327,348,15,21,338,25,363,3,5,4,5,3,2
"Region8","holding","Computer Store","October",12,2,4,3,3,11,499,520,14,21,510,24,534,3,5,4,3,4,2
"Region8","holding","Computer Store","November",12,4,4,3,4,11,472,495,15,23,483,27,510,3,3,5,2,3,2
"Region8","holding","Gaming Zone","January",12,3,4,5,4,12,421,445,16,24,433,28,461,4,4,3,3,4,2
"Region8","holding","Gaming Zone","February",11,4,3,2,4,14,407,427,18,20,421,24,445,3,4,2,4,3,2
"Region8","holding","Gaming Zone","March",10,3,3,4,4,12,454,474,16,20,466,24,490,5,3,5,3,2,4
"Region8","holding","Gaming Zone","April",12,4,5,2,2,15,312,335,17,23,327,25,352,3,2,4,3,4,3
"Region8","holding","Gaming Zone","May",11,4,3,3,3,12,500,521,15,21,512,24,536,4,4,2,4,4,4
"Region8","holding","Gaming Zone","June",12,3,3,4,4,15,386,408,19,22,401,26,427,5,5,3,3,4,5
"Region8","holding","Gaming Zone","July",11,4,2,5,4,15,488,510,19,22,503,26,529,3,3,3,5,5,4
"Region8","holding","Gaming Zone","August",11,4,4,3,2,13,448,470,15,22,461,24,485,3,2,3,4,4,4
"Region8","holding","Gaming Zone","September",13,3,2,5,2,12,446,469,14,23,458,25,483,3,5,3,5,3,4
"Region8","holding","Gaming Zone","October",13,3,4,5,2,15,434,459,17,25,449,27,476,2,5,4,4,2,5
"Region8","holding","Gaming Zone","November",12,4,4,2,4,12,360,382,16,22,372,26,398,2,4,3,3,3,3
"Region8","holding","Super MArket","January",12,2,4,5,2,14,451,474,16,23,465,25,490,3,4,3,4,5,4
"Region8","holding","Super MArket","February",13,3,5,4,3,12,442,467,15,25,454,28,482,4,3,4,4,3,3
"Region8","holding","Super MArket","March",12,2,5,5,2,13,412,436,15,24,425,26,451,5,5,3,3,2,4
"Region8","holding","Super MArket","April",13,3,4,3,4,14,498,521,18,23,512,27,539,4,4,2,5,3,2
"Region8","holding","Super MArket","May",12,4,4,4,4,11,363,387,15,24,374,28,402,4,4,4,5,5,4
"Region8","holding","Super MArket","June",11,3,4,2,4,12,392,412,16,20,404,24,428,4,2,3,3,3,4
"Region8","holding","Super MArket","July",13,5,4,3,3,12,488,513,15,25,500,28,528,2,5,5,2,3,4
"Region8","holding","Super MArket","August",12,4,3,5,3,13,417,441,16,24,430,27,457,5,3,3,2,3,2
"Region8","holding","Super MArket","September",10,5,4,3,3,11,441,463,14,22,452,25,477,4,2,5,5,4,2
"Region8","holding","Super MArket","October",11,5,3,3,5,11,341,363,16,22,352,27,379,4,4,2,5,4,3
"Region8","holding","Super MArket","November",12,3,3,2,3,13,383,403,16,20,396,23,419,3,4,3,4,2,4
"Region8","holding","Fast Food Centre","January",12,3,5,4,3,13,322,346,16,24,335,27,362,2,3,4,4,3,4
"Region8","holding","Fast Food Centre","February",10,5,5,2,2,12,383,405,14,22,395,24,419,3,5,3,5,3,3
"Region8","holding","Fast Food Centre","March",11,3,3,5,3,13,314,336,16,22,327,25,352,2,5,2,4,3,4
"Region8","holding","Fast Food Centre","April",13,5,4,3,5,11,462,487,16,25,473,30,503,3,4,5,4,3,2
"Region8","holding","Fast Food Centre","May",12,2,3,3,4,11,331,351,15,20,342,24,366,4,4,2,3,4,4
"Region8","holding","Fast Food Centre","June",13,5,4,5,3,12,474,501,15,27,486,30,516,2,3,4,4,5,4
"Region8","holding","Fast Food Centre","July",13,4,3,5,5,14,417,442,19,25,431,30,461,3,5,4,4,4,3
"Region8","holding","Fast Food Centre","August",11,5,4,4,2,11,451,475,13,24,462,26,488,2,4,4,4,2,3
"Region8","holding","Fast Food Centre","September",10,4,4,4,4,13,426,448,17,22,439,26,465,3,5,5,5,5,4
"Region8","holding","Fast Food Centre","October",12,3,3,4,5,14,302,324,19,22,316,27,343,3,4,4,5,3,4
"Region8","holding","Fast Food Centre","November",11,4,3,3,5,14,396,417,19,21,410,26,436,4,3,4,5,2,4
"Region9","retail","Retail Store","January",12,4,4,5,5,10,445,470,15,25,455,30,485,3,2,4,3,2,3
"Region9","retail","Retail Store","February",11,3,3,2,4,14,443,462,18,19,457,23,480,2,3,4,5,5,4
"Region9","retail","Retail Store","March",12,5,2,3,2,12,379,401,14,22,391,24,415,4,4,3,4,3,4
"Region9","retail","Retail Store","April",12,2,3,3,4,14,451,471,18,20,465,24,489,3,2,3,5,3,5
"Region9","retail","Retail Store","May",12,2,3,3,4,12,385,405,16,20,397,24,421,3,3,3,4,3,4
"Region9","retail","Retail Store","June",11,4,3,5,2,14,455,478,16,23,469,25,494,3,4,4,4,3,5
"Region9","retail","Retail Store","July",13,3,2,2,4,11,390,410,15,20,401,24,425,5,4,3,2,3,5
"Region9","retail","Retail Store","August",11,4,3,5,3,12,389,412,15,23,401,26,427,2,2,2,3,3,4
"Region9","retail","Retail Store","September",10,4,2,4,4,14,425,445,18,20,439,24,463,4,2,3,5,3,4
"Region9","retail","Retail Store","October",13,2,5,2,3,13,388,410,16,22,401,25,426,5,3,5,4,5,4
"Region9","retail","Retail Store","November",12,2,3,2,3,10,490,509,13,19,500,22,522,5,2,5,3,2,4
"Region9","retail","Kirana Store","January",12,3,5,4,5,11,442,466,16,24,453,29,482,4,2,4,3,2,4
"Region9","retail","Kirana Store","February",12,5,4,2,5,10,387,410,15,23,397,28,425,2,3,3,2,5,5
"Region9","retail","Kirana Store","March",11,3,3,3,2,11,417,437,13,20,428,22,450,3,3,5,5,5,2
"Region9","retail","Kirana Store","April",11,4,4,3,3,13,322,344,16,22,335,25,360,2,2,3,5,3,2
"Region9","retail","Kirana Store","May",13,2,2,5,2,14,344,366,16,22,358,24,382,2,3,3,3,2,2
"Region9","retail","Kirana Store","June",11,3,3,3,3,10,453,473,13,20,463,23,486,4,2,2,3,3,3
"Region9","retail","Kirana Store","July",13,3,3,4,4,13,446,469,17,23,459,27,486,3,2,5,2,3,3
"Region9","retail","Kirana Store","August",12,4,3,4,3,14,318,341,17,23,332,26,358,2,5,4,5,2,3
"Region9","retail","Kirana Store","September",12,2,4,3,3,12,472,493,15,21,484,24,508,3,3,3,3,4,3
"Region9","retail","Kirana Store","October",11,5,4,4,3,13,500,524,16,24,513,27,540,5,3,3,5,5,3
"Region9","retail","Kirana Store","November",12,4,2,2,5,14,456,476,19,20,470,25,495,2,4,3,3,4,4
"Region9","retail","Hotels","January",10,3,4,3,2,11,345,365,13,20,356,22,378,5,3,4,3,3,3
"Region9","retail","Hotels","February",12,4,3,3,4,14,348,370,18,22,362,26,388,3,3,2,3,2,3
"Region9","retail","Hotels","March",11,3,2,3,2,13,383,402,15,19,396,21,417,4,4,5,4,4,3
"Region9","retail","Hotels","April",12,2,3,5,5,11,438,460,16,22,449,27,476,4,3,3,4,5,4
"Region9","retail","Hotels","May",11,3,4,5,5,14,461,484,19,23,475,28,503,5,5,4,3,3,3
"Region9","retail","Hotels","June",13,3,3,3,2,11,425,447,13,22,436,24,460,2,5,4,4,3,4
"Region9","retail","Hotels","July",11,5,3,3,4,10,399,421,14,22,409,26,435,3,5,4,2,4,4
"Region9","retail","Hotels","August",12,4,3,3,3,12,335,357,15,22,347,25,372,3,3,3,3,4,3
"Region9","retail","Hotels","September",11,2,4,5,3,15,390,412,18,22,405,25,430,3,4,4,3,2,3
"Region9","retail","Hotels","October",12,3,5,4,3,10,385,409,13,24,395,27,422,3,4,3,3,4,3
"Region9","retail","Hotels","November",12,2,2,3,2,12,400,419,14,19,412,21,433,2,4,4,4,4,3
"Region9","retail","Restaurants","January",11,3,4,4,3,13,461,483,16,22,474,25,499,2,4,5,5,5,2
"Region9","retail","Restaurants","February",11,3,2,3,2,10,351,370,12,19,361,21,382,5,3,4,5,5,3
"Region9","retail","Restaurants","March",12,4,3,5,4,13,321,345,17,24,334,28,362,4,2,3,2,3,4
"Region9","retail","Restaurants","April",11,2,5,4,3,14,404,426,17,22,418,25,443,3,4,5,3,3,5
"Region9","retail","Restaurants","May",12,3,4,4,4,10,333,356,14,23,343,27,370,3,3,4,3,4,4
"Region9","retail","Restaurants","June",13,5,4,3,4,10,438,463,14,25,448,29,477,4,4,3,3,3,5
"Region9","retail","Restaurants","July",10,4,3,2,5,14,400,419,19,19,414,24,438,3,5,3,3,3,3
"Region9","retail","Restaurants","August",13,4,3,2,3,10,489,511,13,22,499,25,524,4,2,4,4,2,3
"Region9","retail","Restaurants","September",13,4,4,2,3,12,375,398,15,23,387,26,413,5,4,2,4,3,5
"Region9","retail","Restaurants","October",11,2,3,4,4,14,300,320,18,20,314,24,338,4,3,3,3,2,3
"Region9","retail","Restaurants","November",12,3,3,4,3,11,402,424,14,22,413,25,438,4,4,2,3,3,4
"Region9","retail","Airline","January",12,3,4,3,2,13,393,415,15,22,406,24,430,4,2,3,2,4,2
"Region9","retail","Airline","February",11,5,2,4,5,11,438,460,16,22,449,27,476,3,4,3,4,4,3
"Region9","retail","Airline","March",10,3,2,2,3,13,483,500,16,17,496,20,516,4,3,4,4,5,3
"Region9","retail","Airline","April",11,4,4,5,4,14,319,343,18,24,333,28,361,2,3,2,5,3,4
"Region9","retail","Airline","May",11,2,5,4,3,12,461,483,15,22,473,25,498,4,2,3,2,4,5
"Region9","retail","Airline","June",12,3,2,2,4,14,421,440,18,19,435,23,458,4,2,2,2,4,4
"Region9","retail","Airline","July",11,3,3,3,3,14,345,365,17,20,359,23,382,4,4,3,2,5,4
"Region9","retail","Airline","August",12,4,3,2,4,10,496,517,14,21,506,25,531,4,3,5,3,5,3
"Region9","retail","Airline","September",11,4,5,2,2,10,457,479,12,22,467,24,491,4,3,3,2,5,4
"Region9","retail","Airline","October",11,5,5,5,2,10,487,513,12,26,497,28,525,3,4,5,3,4,3
"Region9","retail","Airline","November",13,4,5,3,4,15,377,402,19,25,392,29,421,4,4,4,5,4,4
"Region9","retail","Hardware Store","January",13,2,3,3,4,15,362,383,19,21,377,25,402,4,4,3,3,3,4
"Region9","retail","Hardware Store","February",11,5,4,5,4,14,379,404,18,25,393,29,422,3,3,2,5,3,2
"Region9","retail","Hardware Store","March",12,5,3,4,4,14,312,336,18,24,326,28,354,4,3,3,4,3,3
"Region9","retail","Hardware Store","April",11,4,4,2,4,10,419,440,14,21,429,25,454,4,2,3,4,4,3
"Region9","retail","Hardware Store","May",12,3,5,5,4,14,369,394,18,25,383,29,412,4,3,4,2,4,5
"Region9","retail","Hardware Store","June",10,5,3,3,3,14,480,501,17,21,494,24,518,3,4,2,4,5,5
"Region9","retail","Hardware Store","July",13,4,4,2,2,11,471,494,13,23,482,25,507,5,2,3,5,3,4
"Region9","retail","Hardware Store","August",13,4,3,3,2,13,355,378,15,23,368,25,393,4,3,5,5,3,2
"Region9","retail","Hardware Store","September",12,2,4,3,3,14,346,367,17,21,360,24,384,4,5,2,5,5,5
"Region9","retail","Hardware Store","October",10,3,5,4,5,11,489,511,16,22,500,27,527,4,2,4,2,4,5
"Region9","retail","Hardware Store","November",13,5,3,2,3,13,432,455,16,23,445,26,471,5,5,3,4,4,3
"Region9","retail","Computer Store","January",11,3,5,2,4,12,350,371,16,21,362,25,387,5,5,5,3,3,5
"Region9","retail","Computer Store","February",12,3,3,4,4,13,318,340,17,22,331,26,357,4,4,3,4,3,3
"Region9","retail","Computer Store","March",10,3,3,2,5,14,326,344,19,18,340,23,363,2,3,4,3,3,5
"Region9","retail","Computer Store","April",10,2,4,5,2,10,320,341,12,21,330,23,353,3,2,4,5,4,2
"Region9","retail","Computer Store","May",13,4,2,3,5,13,469,491,18,22,482,27,509,3,4,2,4,5,5
"Region9","retail","Computer Store","June",13,2,4,4,4,15,318,341,19,23,333,27,360,3,3,4,4,5,3
"Region9","retail","Computer Store","July",10,3,3,4,5,14,446,466,19,20,460,25,485,3,4,4,3,5,4
"Region9","retail","Computer Store","August",11,3,5,5,4,14,421,445,18,24,435,28,463,3,5,3,4,3,3
"Region9","retail","Computer Store","September",11,4,4,4,4,14,482,505,18,23,496,27,523,3,2,3,2,4,4
"Region9","retail","Computer Store","October",12,2,5,5,4,13,466,490,17,24,479,28,507,3,3,4,2,4,4
"Region9","retail","Computer Store","November",10,2,3,4,2,14,380,399,16,19,394,21,415,4,4,3,2,3,4
"Region9","retail","Gaming Zone","January",12,5,3,5,3,10,465,490,13,25,475,28,503,2,2,3,4,4,4
"Region9","retail","Gaming Zone","February",12,4,5,3,5,11,301,325,16,24,312,29,341,4,4,3,5,5,4
"Region9","retail","Gaming Zone","March",11,3,3,3,5,12,327,347,17,20,339,25,364,4,2,3,4,3,2
"Region9","retail","Gaming Zone","April",11,4,4,3,3,13,382,404,16,22,395,25,420,3,3,3,4,2,3
"Region9","retail","Gaming Zone","May",12,4,4,4,2,12,341,365,14,24,353,26,379,2,2,2,4,4,5
"Region9","retail","Gaming Zone","June",12,2,4,5,4,13,435,458,17,23,448,27,475,2,3,4,3,2,3
"Region9","retail","Gaming Zone","July",13,5,3,5,2,14,306,332,16,26,320,28,348,3,3,2,2,4,3
"Region9","retail","Gaming Zone","August",12,4,2,2,4,14,388,408,18,20,402,24,426,3,2,4,2,3,3
"Region9","retail","Gaming Zone","September",10,4,3,5,3,14,473,495,17,22,487,25,512,3,4,4,2,4,3
"Region9","retail","Gaming Zone","October",11,2,4,3,3,13,349,369,16,20,362,23,385,2,3,5,3,2,4
"Region9","retail","Gaming Zone","November",11,3,5,4,2,11,356,379,13,23,367,25,392,3,4,5,5,4,3
"Region9","retail","Super MArket","January",11,4,4,3,4,11,458,480,15,22,469,26,495,3,4,3,5,3,5
"Region9","retail","Super MArket","February",11,4,4,4,5,15,322,345,20,23,337,28,365,4,2,4,3,4,2
"Region9","retail","Super MArket","March",11,2,4,5,3,14,452,474,17,22,466,25,491,3,4,4,3,3,3
"Region9","retail","Super MArket","April",11,3,3,2,4,10,355,374,14,19,365,23,388,4,2,3,5,4,2
"Region9","retail","Super MArket","May",11,3,3,3,3,14,440,460,17,20,454,23,477,4,3,3,4,2,4
"Region9","retail","Super MArket","June",12,4,4,2,4,14,300,322,18,22,314,26,340,3,2,4,3,3,3
"Region9","retail","Super MArket","July",12,4,4,4,3,13,339,363,16,24,352,27,379,3,5,3,4,3,4
"Region9","retail","Super MArket","August",13,2,3,4,5,14,474,496,19,22,488,27,515,3,4,4,3,4,3
"Region9","retail","Super MArket","September",12,4,4,3,4,11,356,379,15,23,367,27,394,2,4,3,2,2,2
"Region9","retail","Super MArket","October",12,2,4,2,4,13,429,449,17,20,442,24,466,4,5,4,3,5,5
"Region9","retail","Super MArket","November",12,2,2,4,5,13,354,374,18,20,367,25,392,4,3,5,3,3,3
"Region9","retail","Fast Food Centre","January",13,4,4,2,4,14,437,460,18,23,451,27,478,5,4,4,3,4,2
"Region9","retail","Fast Food Centre","February",12,5,3,5,4,11,385,410,15,25,396,29,425,3,3,4,4,2,3
"Region9","retail","Fast Food Centre","March",11,4,2,5,2,11,416,438,13,22,427,24,451,4,4,2,3,3,3
"Region9","retail","Fast Food Centre","April",13,4,4,2,3,11,450,473,14,23,461,26,487,2,5,3,3,3,5
"Region9","retail","Fast Food Centre","May",12,4,4,2,3,15,378,400,18,22,393,25,418,3,3,3,4,4,2
"Region9","retail","Fast Food Centre","June",12,4,3,2,5,12,426,447,17,21,438,26,464,2,4,4,5,3,5
"Region9","retail","Fast Food Centre","July",13,3,3,5,4,12,341,365,16,24,353,28,381,4,5,4,3,3,3
"Region9","retail","Fast Food Centre","August",10,4,3,4,3,12,325,346,15,21,337,24,361,4,3,2,2,3,4
"Region9","retail","Fast Food Centre","September",12,3,2,2,2,15,406,425,17,19,421,21,442,3,2,5,3,5,3
"Region9","retail","Fast Food Centre","October",13,3,5,5,3,12,477,503,15,26,489,29,518,3,4,5,3,5,2
"Region9","retail","Fast Food Centre","November",11,3,4,3,4,14,345,366,18,21,359,25,384,3,4,4,3,4,4
"Region9","holding","Retail Store","January",11,4,3,3,4,10,453,474,14,21,463,25,488,4,3,3,4,3,5
"Region9","holding","Retail Store","February",12,3,5,2,2,10,300,322,12,22,310,24,334,2,3,5,3,4,4
"Region9","holding","Retail Store","March",13,5,4,4,4,13,337,363,17,26,350,30,380,4,3,3,2,3,2
"Region9","holding","Retail Store","April",13,4,3,4,4,12,485,509,16,24,497,28,525,4,4,3,4,4,2
"Region9","holding","Retail Store","May",12,3,4,4,5,13,430,453,18,23,443,28,471,3,3,4,4,2,2
"Region9","holding","Retail Store","June",13,4,3,5,4,12,385,410,16,25,397,29,426,4,4,5,4,3,3
"Region9","holding","Retail Store","July",11,3,3,3,5,10,350,370,15,20,360,25,385,4,3,3,2,3,4
"Region9","holding","Retail Store","August",11,5,3,4,4,12,434,457,16,23,446,27,473,4,2,3,4,2,3
"Region9","holding","Retail Store","September",13,2,4,5,4,13,443,467,17,24,456,28,484,5,3,2,4,4,4
"Region9","holding","Retail Store","October",13,4,2,3,3,13,366,388,16,22,379,25,404,4,3,4,3,2,4
"Region9","holding","Retail Store","November",13,4,4,2,2,11,436,459,13,23,447,25,472,5,5,4,4,3,5
"Region9","holding","Kirana Store","January",11,4,3,3,3,11,427,448,14,21,438,24,462,3,2,4,4,4,2
"Region9","holding","Kirana Store","February",11,3,2,3,2,13,487,506,15,19,500,21,521,5,5,5,4,5,2
"Region9","holding","Kirana Store","March",11,2,3,5,3,11,495,516,14,21,506,24,530,5,3,2,3,4,5
"Region9","holding","Kirana Store","April",11,4,3,5,4,15,474,497,19,23,489,27,516,4,3,5,3,2,5
"Region9","holding","Kirana Store","May",12,2,3,5,5,10,430,452,15,22,440,27,467,5,4,5,3,5,3
"Region9","holding","Kirana Store","June",11,5,3,5,3,12,347,371,15,24,359,27,386,5,3,4,5,2,5
"Region9","holding","Kirana Store","July",11,4,5,3,3,11,397,420,14,23,408,26,434,3,5,5,2,3,5
"Region9","holding","Kirana Store","August",10,2,5,4,4,13,465,486,17,21,478,25,503,2,2,5,4,5,5
"Region9","holding","Kirana Store","September",11,4,4,4,3,12,376,399,15,23,388,26,414,3,2,3,4,5,4
"Region9","holding","Kirana Store","October",13,4,4,2,3,13,393,416,16,23,406,26,432,3,3,2,2,3,4
"Region9","holding","Kirana Store","November",12,2,4,3,2,14,404,425,16,21,418,23,441,4,3,2,4,5,2
"Region9","holding","Hotels","January",11,3,4,4,5,15,313,335,20,22,328,27,355,2,2,4,2,3,2
"Region9","holding","Hotels","February",10,2,5,4,2,14,458,479,16,21,472,23,495,5,3,5,3,2,3
"Region9","holding","Hotels","March",12,4,4,4,4,12,374,398,16,24,386,28,414,4,3,2,5,4,5
"Region9","holding","Hotels","April",11,5,5,4,5,14,322,347,19,25,336,30,366,4,5,4,3,2,3
"Region9","holding","Hotels","May",11,2,5,2,4,12,430,450,16,20,442,24,466,4,3,4,3,4,4
"Region9","holding","Hotels","June",12,2,4,4,3,11,426,448,14,22,437,25,462,3,4,3,3,4,4
"Region9","holding","Hotels","July",12,4,3,4,3,13,322,345,16,23,335,26,361,5,4,2,3,3,5
"Region9","holding","Hotels","August",11,2,4,5,5,14,369,391,19,22,383,27,410,4,2,4,2,4,3
"Region9","holding","Hotels","September",11,2,4,3,3,12,466,486,15,20,478,23,501,4,2,3,3,2,4
"Region9","holding","Hotels","October",13,3,4,3,3,15,404,427,18,23,419,26,445,2,5,4,4,4,3
"Region9","holding","Hotels","November",11,4,4,5,5,14,399,423,19,24,413,29,442,2,4,4,4,4,5
"Region9","holding","Restaurants","January",11,5,2,4,3,14,490,512,17,22,504,25,529,4,4,4,5,5,4
"Region9","holding","Restaurants","February",12,5,4,3,4,13,330,354,17,24,343,28,371,3,3,5,4,5,5
"Region9","holding","Restaurants","March",11,5,3,5,4,10,494,518,14,24,504,28,532,3,4,4,3,3,5
"Region9","holding","Restaurants","April",11,2,3,4,2,15,328,348,17,20,343,22,365,2,4,5,5,2,5
"Region9","holding","Restaurants","May",11,5,3,5,4,11,348,372,15,24,359,28,387,4,3,4,4,3,4
"Region9","holding","Restaurants","June",11,4,4,5,2,15,401,425,17,24,416,26,442,4,5,3,4,4,3
"Region9","holding","Restaurants","July",12,3,5,3,3,10,377,400,13,23,387,26,413,5,3,2,4,4,5
"Region9","holding","Restaurants","August",12,4,4,4,4,12,355,379,16,24,367,28,395,4,3,2,4,5,3
"Region9","holding","Restaurants","September",12,4,5,3,3,10,375,399,13,24,385,27,412,4,4,4,4,4,4
"Region9","holding","Restaurants","October",11,3,5,3,4,12,404,426,16,22,416,26,442,3,2,5,5,4,5
"Region9","holding","Restaurants","November",13,3,4,4,3,12,318,342,15,24,330,27,357,4,4,4,4,3,4
"Region9","holding","Airline","January",12,5,3,3,2,14,361,384,16,23,375,25,400,3,3,4,3,5,3
"Region9","holding","Airline","February",11,5,2,4,3,12,443,465,15,22,455,25,480,5,5,4,4,3,5
"Region9","holding","Airline","March",10,3,2,3,4,15,331,349,19,18,346,22,368,2,2,2,3,3,2
"Region9","holding","Airline","April",13,4,5,4,3,12,333,359,15,26,345,29,374,5,2,4,4,4,3
"Region9","holding","Airline","May",12,4,2,3,5,11,357,378,16,21,368,26,394,4,3,2,2,2,2
"Region9","holding","Airline","June",13,5,5,3,4,15,372,398,19,26,387,30,417,3,2,3,3,5,3
"Region9","holding","Airline","July",12,3,4,4,5,13,441,464,18,23,454,28,482,4,4,4,2,3,5
"Region9","holding","Airline","August",12,2,5,4,3,14,491,514,17,23,505,26,531,4,2,5,2,5,5
"Region9","holding","Airline","September",11,4,2,2,2,10,344,363,12,19,354,21,375,2,5,3,2,3,3
"Region9","holding","Airline","October",10,5,4,3,4,10,351,373,14,22,361,26,387,3,4,4,4,4,4
"Region9","holding","Airline","November",13,3,2,4,4,14,448,470,18,22,462,26,488,3,3,3,3,3,3
"Region9","holding","Hardware Store","January",11,4,5,3,5,13,334,357,18,23,347,28,375,3,4,3,3,3,3
"Region9","holding","Hardware Store","February",11,2,3,3,5,10,491,510,15,19,501,24,525,4,3,4,3,2,2
"Region9","holding","Hardware Store","March",12,2,3,3,4,13,378,398,17,20,391,24,415,3,3,3,5,3,5
"Region9","holding","Hardware Store","April",10,2,3,4,3,11,351,370,14,19,362,22,384,5,5,5,2,3,3
"Region9","holding","Hardware Store","May",11,5,3,3,4,14,384,406,18,22,398,26,424,3,3,4,4,4,2
"Region9","holding","Hardware Store","June",11,4,5,2,3,13,483,505,16,22,496,25,521,3,4,5,2,3,4
"Region9","holding","Hardware Store","July",13,5,5,5,3,14,415,443,17,28,429,31,460,2,2,2,5,2,3
"Region9","holding","Hardware Store","August",10,4,4,5,4,13,439,462,17,23,452,27,479,4,4,3,5,4,5
"Region9","holding","Hardware Store","September",12,3,4,3,3,12,308,330,15,22,320,25,345,5,3,3,3,4,5
"Region9","holding","Hardware Store","October",11,3,3,3,3,14,463,483,17,20,477,23,500,5,2,5,3,2,4
"Region9","holding","Hardware Store","November",13,3,4,5,4,14,416,441,18,25,430,29,459,3,5,2,3,4,4
"Region9","holding","Computer Store","January",13,3,2,3,5,13,357,378,18,21,370,26,396,3,5,2,4,4,4
"Region9","holding","Computer Store","February",11,5,3,2,5,13,368,389,18,21,381,26,407,2,4,3,2,3,2
"Region9","holding","Computer Store","March",12,4,4,4,3,13,399,423,16,24,412,27,439,3,5,4,2,5,5
"Region9","holding","Computer Store","April",10,2,5,3,5,12,388,408,17,20,400,25,425,4,4,4,4,2,2
"Region9","holding","Computer Store","May",11,5,3,3,4,15,488,510,19,22,503,26,529,4,2,3,5,3,3
"Region9","holding","Computer Store","June",13,2,3,2,3,14,464,484,17,20,478,23,501,2,4,5,5,5,2
"Region9","holding","Computer Store","July",12,4,2,3,3,12,395,416,15,21,407,24,431,4,3,4,2,5,3
"Region9","holding","Computer Store","August",11,4,3,3,3,12,311,332,15,21,323,24,347,5,3,2,5,5,5
"Region9","holding","Computer Store","September",11,2,5,2,4,13,459,479,17,20,472,24,496,4,5,3,3,4,4
"Region9","holding","Computer Store","October",13,3,5,4,4,13,380,405,17,25,393,29,422,4,3,4,4,4,2
"Region9","holding","Computer Store","November",12,5,2,2,3,11,308,329,14,21,319,24,343,2,4,2,3,4,5
"Region9","holding","Gaming Zone","January",11,4,3,5,4,12,309,332,16,23,321,27,348,4,3,2,5,2,3
"Region9","holding","Gaming Zone","February",12,4,2,4,4,13,369,391,17,22,382,26,408,4,3,3,3,2,4
"Region9","holding","Gaming Zone","March",12,2,4,5,4,11,408,431,15,23,419,27,446,2,4,3,4,3,5
"Region9","holding","Gaming Zone","April",12,4,5,3,4,14,491,515,18,24,505,28,533,4,4,3,3,4,3
"Region9","holding","Gaming Zone","May",11,4,4,5,2,14,308,332,16,24,322,26,348,2,4,5,4,4,3
"Region9","holding","Gaming Zone","June",11,2,3,2,5,15,436,454,20,18,451,23,474,5,3,5,4,4,5
"Region9","holding","Gaming Zone","July",10,3,3,3,4,15,498,517,19,19,513,23,536,4,3,5,5,3,2
"Region9","holding","Gaming Zone","August",13,2,2,3,4,11,340,360,15,20,351,24,375,3,3,4,5,3,3
"Region9","holding","Gaming Zone","September",11,4,4,2,2,11,480,501,13,21,491,23,514,4,2,2,4,3,4
"Region9","holding","Gaming Zone","October",13,3,4,3,4,14,494,517,18,23,508,27,535,3,3,3,5,3,4
"Region9","holding","Gaming Zone","November",12,4,4,3,3,10,472,495,13,23,482,26,508,3,3,5,5,4,2
"Region9","holding","Super MArket","January",13,4,5,4,4,12,329,355,16,26,341,30,371,2,3,3,3,2,4
"Region9","holding","Super MArket","February",12,4,3,3,3,13,390,412,16,22,403,25,428,4,5,4,3,2,3
"Region9","holding","Super MArket","March",12,4,4,4,5,12,499,523,17,24,511,29,540,2,2,2,5,3,2
"Region9","holding","Super MArket","April",11,2,2,5,3,12,360,380,15,20,372,23,395,3,3,4,3,2,5
"Region9","holding","Super MArket","May",11,3,5,4,2,11,408,431,13,23,419,25,444,3,3,4,4,5,4
"Region9","holding","Super MArket","June",12,4,4,3,4,11,311,334,15,23,322,27,349,3,3,2,5,3,2
"Region9","holding","Super MArket","July",12,3,4,3,4,13,449,471,17,22,462,26,488,3,3,4,5,5,3
"Region9","holding","Super MArket","August",10,4,3,3,3,13,304,324,16,20,317,23,340,2,5,3,2,3,5
"Region9","holding","Super MArket","September",13,3,4,4,2,13,432,456,15,24,445,26,471,4,5,2,2,3,4
"Region9","holding","Super MArket","October",12,3,4,2,4,10,378,399,14,21,388,25,413,5,4,2,4,3,4
"Region9","holding","Super MArket","November",10,2,2,3,4,13,373,390,17,17,386,21,407,2,3,5,4,5,3
"Region9","holding","Fast Food Centre","January",13,2,4,4,3,11,492,515,14,23,503,26,529,4,3,3,4,5,2
"Region9","holding","Fast Food Centre","February",12,3,2,3,5,14,499,519,19,20,513,25,538,4,4,3,4,4,3
"Region9","holding","Fast Food Centre","March",11,5,4,5,2,13,365,390,15,25,378,27,405,4,4,2,4,5,3
"Region9","holding","Fast Food Centre","April",13,4,3,2,5,13,318,340,18,22,331,27,358,3,2,3,3,3,5
"Region9","holding","Fast Food Centre","May",12,3,4,3,3,11,417,439,14,22,428,25,453,2,4,2,3,5,2
"Region9","holding","Fast Food Centre","June",11,4,4,4,4,14,321,344,18,23,335,27,362,4,5,3,3,4,4
"Region9","holding","Fast Food Centre","July",12,2,4,4,2,15,303,325,17,22,318,24,342,2,3,3,3,5,3
"Region9","holding","Fast Food Centre","August",12,5,4,2,2,11,422,445,13,23,433,25,458,2,5,4,4,3,5
"Region9","holding","Fast Food Centre","September",10,5,4,5,3,12,496,520,15,24,508,27,535,3,3,3,4,5,4
"Region9","holding","Fast Food Centre","October",12,4,3,4,3,12,389,412,15,23,401,26,427,2,2,2,4,2,5
"Region9","holding","Fast Food Centre","November",12,4,4,4,5,14,424,448,19,24,438,29,467,4,3,5,4,5,4
"Region10","retail","Retail Store","January",12,3,5,4,3,14,468,492,17,24,482,27,509,4,5,4,4,3,4
"Region10","retail","Retail Store","February",12,3,4,4,3,12,496,519,15,23,508,26,534,3,3,2,2,4,3
"Region10","retail","Retail Store","March",10,4,4,3,4,14,332,353,18,21,346,25,371,5,4,4,5,2,2
"Region10","retail","Retail Store","April",11,4,4,3,2,11,331,353,13,22,342,24,366,5,5,2,3,5,4
"Region10","retail","Retail Store","May",13,3,4,3,3,14,370,393,17,23,384,26,410,4,5,3,4,4,3
"Region10","retail","Retail Store","June",12,4,3,5,4,15,404,428,19,24,419,28,447,2,2,5,4,4,4
"Region10","retail","Retail Store","July",11,5,2,4,3,12,428,450,15,22,440,25,465,4,2,3,4,2,4
"Region10","retail","Retail Store","August",10,2,2,3,4,10,431,448,14,17,441,21,462,3,5,4,4,4,2
"Region10","retail","Retail Store","September",11,3,2,4,2,12,431,451,14,20,443,22,465,3,3,3,2,5,2
"Region10","retail","Retail Store","October",12,4,5,3,5,14,459,483,19,24,473,29,502,3,2,2,3,3,4
"Region10","retail","Retail Store","November",11,4,4,3,5,13,447,469,18,22,460,27,487,4,5,4,4,2,3
"Region10","retail","Kirana Store","January",12,4,3,4,4,11,429,452,15,23,440,27,467,4,5,5,4,2,3
"Region10","retail","Kirana Store","February",11,3,4,4,3,12,380,402,15,22,392,25,417,3,3,5,4,5,3
"Region10","retail","Kirana Store","March",12,5,2,5,5,13,384,408,18,24,397,29,426,2,3,4,3,4,5
"Region10","retail","Kirana Store","April",12,4,2,3,3,12,351,372,15,21,363,24,387,4,4,4,5,4,5
"Region10","retail","Kirana Store","May",12,4,5,4,2,14,357,382,16,25,371,27,398,4,3,3,4,3,4
"Region10","retail","Kirana Store","June",10,3,3,3,4,11,380,399,15,19,391,23,414,4,3,2,4,4,2
"Region10","retail","Kirana Store","July",13,3,4,3,3,10,380,403,13,23,390,26,416,3,3,4,4,2,2
"Region10","retail","Kirana Store","August",11,4,4,3,4,14,414,436,18,22,428,26,454,2,3,2,4,4,3
"Region10","retail","Kirana Store","September",10,3,3,3,3,14,300,319,17,19,314,22,336,5,2,4,4,3,3
"Region10","retail","Kirana Store","October",13,4,5,3,5,14,303,328,19,25,317,30,347,4,3,3,4,3,2
"Region10","retail","Kirana Store","November",11,4,4,3,4,15,382,404,19,22,397,26,423,4,3,3,4,2,3
"Region10","retail","Hotels","January",12,3,4,4,4,13,338,361,17,23,351,27,378,3,3,2,3,5,3
"Region10","retail","Hotels","February",12,4,4,4,4,14,365,389,18,24,379,28,407,5,4,2,3,4,4
"Region10","retail","Hotels","March",11,5,3,3,2,13,350,372,15,22,363,24,387,5,3,4,5,3,5
"Region10","retail","Hotels","April",13,3,5,2,5,12,492,515,17,23,504,28,532,5,3,2,5,4,3
"Region10","retail","Hotels","May",12,4,5,5,4,14,436,462,18,26,450,30,480,4,4,3,5,4,4
"Region10","retail","Hotels","June",12,4,3,3,3,14,485,507,17,22,499,25,524,3,3,4,4,3,4
"Region10","retail","Hotels","July",12,4,3,4,3,11,338,361,14,23,349,26,375,4,5,3,3,4,5
"Region10","retail","Hotels","August",12,5,5,2,2,15,362,386,17,24,377,26,403,4,3,4,3,5,2
"Region10","retail","Hotels","September",13,5,5,5,2,13,441,469,15,28,454,30,484,2,4,3,5,5,3
"Region10","retail","Hotels","October",13,3,4,4,3,13,366,390,16,24,379,27,406,3,4,4,3,4,3
"Region10","retail","Hotels","November",13,2,5,2,5,11,352,374,16,22,363,27,390,4,3,5,4,3,4
"Region10","retail","Restaurants","January",12,4,4,3,2,11,322,345,13,23,333,25,358,5,3,4,4,3,4
"Region10","retail","Restaurants","February",12,3,3,4,2,13,402,424,15,22,415,24,439,5,5,4,3,4,2
"Region10","retail","Restaurants","March",11,4,5,5,4,11,437,462,15,25,448,29,477,3,2,4,3,2,2
"Region10","retail","Restaurants","April",11,5,2,2,5,11,439,459,16,20,450,25,475,2,4,4,3,4,5
"Region10","retail","Restaurants","May",12,4,3,4,5,10,489,512,15,23,499,28,527,2,4,3,3,4,5
"Region10","retail","Restaurants","June",12,4,5,5,4,13,363,389,17,26,376,30,406,2,3,4,5,3,3
"Region10","retail","Restaurants","July",11,5,4,3,3,15,354,377,18,23,369,26,395,3,2,3,2,3,5
"Region10","retail","Restaurants","August",11,3,5,4,3,10,445,468,13,23,455,26,481,3,2,4,4,3,2
"Region10","retail","Restaurants","September",13,3,4,3,3,12,450,473,15,23,462,26,488,5,2,5,5,3,4
"Region10","retail","Restaurants","October",12,4,2,4,4,11,387,409,15,22,398,26,424,5,4,4,4,3,3
"Region10","retail","Restaurants","November",10,3,4,4,4,11,374,395,15,21,385,25,410,5,2,4,5,3,2
"Region10","retail","Airline","January",10,4,5,5,2,15,433,457,17,24,448,26,474,3,5,4,4,2,4
"Region10","retail","Airline","February",12,4,3,4,4,14,407,430,18,23,421,27,448,4,3,3,4,2,4
"Region10","retail","Airline","March",11,3,4,3,2,10,366,387,12,21,376,23,399,2,3,4,4,5,4
"Region10","retail","Airline","April",12,3,3,4,4,11,327,349,15,22,338,26,364,4,4,2,4,4,2
"Region10","retail","Airline","May",11,4,5,2,3,15,491,513,18,22,506,25,531,3,4,3,3,3,3
"Region10","retail","Airline","June",11,4,4,3,5,15,490,512,20,22,505,27,532,4,3,3,3,3,3
"Region10","retail","Airline","July",11,4,3,4,2,11,417,439,13,22,428,24,452,5,5,3,4,4,3
"Region10","retail","Airline","August",12,3,3,4,5,11,420,442,16,22,431,27,458,2,5,4,3,3,2
"Region10","retail","Airline","September",12,2,3,3,2,10,406,426,12,20,416,22,438,3,3,4,4,4,4
"Region10","retail","Airline","October",10,5,5,5,3,11,315,340,14,25,326,28,354,2,5,3,3,4,5
"Region10","retail","Airline","November",11,4,2,3,3,15,407,427,18,20,422,23,445,3,3,2,3,3,4
"Region10","retail","Hardware Store","January",12,5,3,5,3,11,352,377,14,25,363,28,391,5,2,5,3,3,4
"Region10","retail","Hardware Store","February",10,3,4,4,4,11,310,331,15,21,321,25,346,5,2,4,4,2,4
"Region10","retail","Hardware Store","March",13,3,4,2,2,13,378,400,15,22,391,24,415,4,5,4,5,3,4
"Region10","retail","Hardware Store","April",11,5,5,5,4,14,421,447,18,26,435,30,465,4,4,3,3,3,4
"Region10","retail","Hardware Store","May",11,2,4,4,3,14,335,356,17,21,349,24,373,2,3,4,3,4,4
"Region10","retail","Hardware Store","June",12,2,3,4,5,10,386,407,15,21,396,26,422,4,3,3,2,3,3
"Region10","retail","Hardware Store","July",11,4,3,5,4,10,489,512,14,23,499,27,526,4,4,4,3,3,4
"Region10","retail","Hardware Store","August",11,3,4,3,5,11,481,502,16,21,492,26,518,3,4,4,4,5,4
"Region10","retail","Hardware Store","September",11,3,4,5,2,12,386,409,14,23,398,25,423,3,4,4,3,3,3
"Region10","retail","Hardware Store","October",11,4,3,3,2,13,399,420,15,21,412,23,435,3,4,5,2,3,3
"Region10","retail","Hardware Store","November",11,5,2,2,3,12,329,349,15,20,341,23,364,3,5,4,2,4,2
"Region10","retail","Computer Store","January",11,5,3,2,3,10,499,520,13,21,509,24,533,3,4,3,4,2,4
"Region10","retail","Computer Store","February",11,5,2,3,3,13,460,481,16,21,473,24,497,5,3,3,5,5,4
"Region10","retail","Computer Store","March",12,3,3,4,2,11,430,452,13,22,441,24,465,2,5,3,4,5,3
"Region10","retail","Computer Store","April",12,3,4,3,3,12,447,469,15,22,459,25,484,3,3,3,5,4,3
"Region10","retail","Computer Store","May",11,3,3,3,3,12,315,335,15,20,327,23,350,3,4,4,3,2,4
"Region10","retail","Computer Store","June",12,3,4,4,3,13,409,432,16,23,422,26,448,2,4,5,4,3,3
"Region10","retail","Computer Store","July",12,5,3,2,2,11,314,336,13,22,325,24,349,3,2,4,3,3,4
"Region10","retail","Computer Store","August",10,5,4,5,4,12,323,347,16,24,335,28,363,4,4,3,4,4,4
"Region10","retail","Computer Store","September",12,5,4,3,4,12,494,518,16,24,506,28,534,2,3,4,2,4,3
"Region10","retail","Computer Store","October",11,4,2,3,4,12,417,437,16,20,429,24,453,5,3,2,4,5,3
"Region10","retail","Computer Store","November",11,3,3,5,3,11,347,369,14,22,358,25,383,3,3,3,3,4,3
"Region10","retail","Gaming Zone","January",12,3,3,3,4,12,437,458,16,21,449,25,474,2,4,4,5,2,3
"Region10","retail","Gaming Zone","February",13,2,3,2,2,13,317,337,15,20,330,22,352,3,5,2,4,4,4
"Region10","retail","Gaming Zone","March",11,3,3,5,4,13,377,399,17,22,390,26,416,4,3,3,4,4,4
"Region10","retail","Gaming Zone","April",11,4,3,2,4,13,457,477,17,20,470,24,494,4,4,2,4,3,5
"Region10","retail","Gaming Zone","May",10,5,3,4,5,11,446,468,16,22,457,27,484,3,5,3,4,4,3
"Region10","retail","Gaming Zone","June",12,4,5,2,4,11,313,336,15,23,324,27,351,4,4,5,4,5,4
"Region10","retail","Gaming Zone","July",11,4,5,5,4,11,449,474,15,25,460,29,489,3,2,3,4,4,3
"Region10","retail","Gaming Zone","August",11,3,3,4,3,10,469,490,13,21,479,24,503,3,3,3,3,2,2
"Region10","retail","Gaming Zone","September",11,4,5,4,5,10,463,487,15,24,473,29,502,3,4,3,4,4,5
"Region10","retail","Gaming Zone","October",10,4,3,3,5,11,375,395,16,20,386,25,411,4,3,4,3,5,3
"Region10","retail","Gaming Zone","November",13,2,4,3,2,12,384,406,14,22,396,24,420,5,3,5,4,2,3
"Region10","retail","Super MArket","January",11,2,3,2,3,14,481,499,17,18,495,21,516,3,4,4,5,5,2
"Region10","retail","Super MArket","February",10,3,3,5,3,12,473,494,15,21,485,24,509,4,2,3,4,2,5
"Region10","retail","Super MArket","March",12,4,3,3,5,13,443,465,18,22,456,27,483,2,2,2,2,3,5
"Region10","retail","Super MArket","April",13,2,5,2,4,10,301,323,14,22,311,26,337,3,4,4,2,3,4
"Region10","retail","Super MArket","May",13,3,2,3,2,14,357,378,16,21,371,23,394,4,2,3,2,4,3
"Region10","retail","Super MArket","June",12,2,5,4,5,12,447,470,17,23,459,28,487,3,3,5,3,2,3
"Region10","retail","Super MArket","July",11,5,4,4,3,13,388,412,16,24,401,27,428,4,4,3,5,3,2
"Region10","retail","Super MArket","August",12,4,3,4,4,12,321,344,16,23,333,27,360,2,2,4,3,4,3
"Region10","retail","Super MArket","September",10,2,4,3,3,13,335,354,16,19,348,22,370,2,3,5,4,3,3
"Region10","retail","Super MArket","October",12,4,3,4,3,10,424,447,13,23,434,26,460,5,4,3,2,2,5
"Region10","retail","Super MArket","November",12,3,4,5,4,11,429,453,15,24,440,28,468,4,4,3,2,4,5
"Region10","retail","Fast Food Centre","January",10,3,5,3,3,15,384,405,18,21,399,24,423,5,4,3,3,3,4
"Region10","retail","Fast Food Centre","February",11,2,2,4,4,14,308,327,18,19,322,23,345,5,2,3,4,2,3
"Region10","retail","Fast Food Centre","March",12,3,4,4,3,12,491,514,15,23,503,26,529,5,3,5,3,3,3
"Region10","retail","Fast Food Centre","April",12,2,4,3,3,14,401,422,17,21,415,24,439,3,2,4,5,3,4
"Region10","retail","Fast Food Centre","May",12,4,3,3,3,13,335,357,16,22,348,25,373,5,5,5,3,5,3
"Region10","retail","Fast Food Centre","June",10,4,4,4,2,13,428,450,15,22,441,24,465,5,2,2,4,5,2
"Region10","retail","Fast Food Centre","July",10,2,2,3,3,13,401,418,16,17,414,20,434,4,2,2,5,3,3
"Region10","retail","Fast Food Centre","August",12,4,3,4,2,13,384,407,15,23,397,25,422,4,3,4,4,4,3
"Region10","retail","Fast Food Centre","September",13,2,3,3,3,10,341,362,13,21,351,24,375,3,5,3,2,2,4
"Region10","retail","Fast Food Centre","October",12,3,2,5,3,12,316,338,15,22,328,25,353,4,4,4,4,3,4
"Region10","retail","Fast Food Centre","November",11,3,4,2,2,10,335,355,12,20,345,22,367,2,3,2,4,4,4
"Region10","holding","Retail Store","January",12,3,4,4,3,12,405,428,15,23,417,26,443,3,3,4,4,2,2
"Region10","holding","Retail Store","February",13,2,3,4,3,12,328,350,15,22,340,25,365,2,2,3,3,3,3
"Region10","holding","Retail Store","March",10,3,3,4,4,15,354,374,19,20,369,24,393,4,4,3,3,2,4
"Region10","holding","Retail Store","April",12,4,3,3,2,12,377,399,14,22,389,24,413,4,3,2,4,3,3
"Region10","holding","Retail Store","May",11,4,3,4,4,15,338,360,19,22,353,26,379,2,5,3,5,3,4
"Region10","holding","Retail Store","June",11,4,3,4,5,11,471,493,16,22,482,27,509,3,4,2,2,3,4
"Region10","holding","Retail Store","July",10,4,3,3,2,11,336,356,13,20,347,22,369,2,5,2,4,3,4
"Region10","holding","Retail Store","August",12,5,4,3,4,13,328,352,17,24,341,28,369,4,2,2,4,5,3
"Region10","holding","Retail Store","September",10,4,4,5,4,15,347,370,19,23,362,27,389,5,3,3,3,2,2
"Region10","holding","Retail Store","October",11,5,4,5,3,13,464,489,16,25,477,28,505,3,5,4,3,5,2
"Region10","holding","Retail Store","November",11,4,5,3,4,14,449,472,18,23,463,27,490,3,3,4,3,2,4
"Region10","holding","Kirana Store","January",11,3,3,4,3,12,393,414,15,21,405,24,429,3,4,4,2,3,4
"Region10","holding","Kirana Store","February",12,3,3,3,2,12,466,487,14,21,478,23,501,5,4,4,3,3,2
"Region10","holding","Kirana Store","March",13,2,3,4,3,13,444,466,16,22,457,25,482,2,5,4,4,2,3
"Region10","holding","Kirana Store","April",11,3,4,4,4,13,496,518,17,22,509,26,535,5,2,3,2,3,4
"Region10","holding","Kirana Store","May",12,3,3,3,4,12,458,479,16,21,470,25,495,4,3,3,3,3,2
"Region10","holding","Kirana Store","June",13,3,4,2,3,13,409,431,16,22,422,25,447,4,3,2,2,5,3
"Region10","holding","Kirana Store","July",12,3,4,3,3,11,343,365,14,22,354,25,379,2,3,4,3,5,4
"Region10","holding","Kirana Store","August",12,4,4,3,3,11,469,492,14,23,480,26,506,3,5,3,4,3,3
"Region10","holding","Kirana Store","September",12,3,3,2,5,10,347,367,15,20,357,25,382,4,2,5,3,4,4
"Region10","holding","Kirana Store","October",10,4,3,3,3,13,403,423,16,20,416,23,439,5,4,4,2,4,4
"Region10","holding","Kirana Store","November",12,4,3,3,4,12,395,417,16,22,407,26,433,3,2,2,4,5,4
"Region10","holding","Hotels","January",10,4,3,3,5,14,336,356,19,20,350,25,375,5,4,3,3,4,3
"Region10","holding","Hotels","February",11,3,2,3,3,10,464,483,13,19,474,22,496,3,4,4,3,3,3
"Region10","holding","Hotels","March",10,2,5,4,4,12,327,348,16,21,339,25,364,4,3,2,5,4,5
"Region10","holding","Hotels","April",11,2,4,4,4,12,418,439,16,21,430,25,455,4,5,5,4,4,2
"Region10","holding","Hotels","May",12,2,4,3,4,11,347,368,15,21,358,25,383,2,5,3,2,4,3
"Region10","holding","Hotels","June",10,3,3,3,3,10,481,500,13,19,491,22,513,2,4,2,4,5,4
"Region10","holding","Hotels","July",11,4,5,4,5,13,493,517,18,24,506,29,535,5,3,4,4,4,5
"Region10","holding","Hotels","August",12,3,3,5,5,12,486,509,17,23,498,28,526,3,4,5,4,4,4
"Region10","holding","Hotels","September",12,4,4,4,4,13,431,455,17,24,444,28,472,3,4,3,4,4,3
"Region10","holding","Hotels","October",12,4,3,5,4,12,303,327,16,24,315,28,343,3,2,4,4,4,3
"Region10","holding","Hotels","November",12,2,4,4,4,15,469,491,19,22,484,26,510,3,4,3,5,2,3
"Region10","holding","Restaurants","January",10,4,5,3,4,12,444,466,16,22,456,26,482,4,4,2,4,3,2
"Region10","holding","Restaurants","February",11,3,3,3,5,10,366,386,15,20,376,25,401,3,4,3,3,5,3
"Region10","holding","Restaurants","March",10,5,5,5,5,13,447,472,18,25,460,30,490,4,4,5,2,3,4
"Region10","holding","Restaurants","April",12,5,4,3,5,11,497,521,16,24,508,29,537,4,3,5,4,4,2
"Region10","holding","Restaurants","May",12,5,4,3,2,12,460,484,14,24,472,26,498,4,3,5,4,4,3
"Region10","holding","Restaurants","June",12,3,3,2,4,15,349,369,19,20,364,24,388,3,3,3,4,2,4
"Region10","holding","Restaurants","July",12,4,2,3,3,11,420,441,14,21,431,24,455,3,4,3,3,3,3
"Region10","holding","Restaurants","August",10,3,4,4,2,14,343,364,16,21,357,23,380,2,4,3,4,4,3
"Region10","holding","Restaurants","September",12,4,4,3,3,14,388,411,17,23,402,26,428,3,3,5,3,5,3
"Region10","holding","Restaurants","October",12,3,2,3,5,13,428,448,18,20,441,25,466,5,4,2,5,5,3
"Region10","holding","Restaurants","November",12,2,5,5,3,14,446,470,17,24,460,27,487,5,5,3,4,5,2
"Region10","holding","Airline","January",12,2,3,4,5,11,418,439,16,21,429,26,455,4,3,4,5,5,2
"Region10","holding","Airline","February",12,4,3,2,3,12,457,478,15,21,469,24,493,2,4,4,5,3,4
"Region10","holding","Airline","March",10,2,2,5,3,14,313,332,17,19,327,22,349,4,3,4,4,4,3
"Region10","holding","Airline","April",11,5,3,5,4,14,322,346,18,24,336,28,364,3,2,2,2,4,2
"Region10","holding","Airline","May",12,3,3,4,3,11,407,429,14,22,418,25,443,4,3,3,5,3,2
"Region10","holding","Airline","June",11,4,4,4,4,11,422,445,15,23,433,27,460,4,3,4,4,3,4
"Region10","holding","Airline","July",12,3,3,5,3,11,495,518,14,23,506,26,532,4,4,2,4,2,4
"Region10","holding","Airline","August",12,3,4,2,3,14,370,391,17,21,384,24,408,2,4,3,4,5,5
"Region10","holding","Airline","September",12,2,3,3,2,13,449,469,15,20,462,22,484,5,2,4,4,3,3
"Region10","holding","Airline","October",13,4,4,3,4,13,387,411,17,24,400,28,428,4,4,3,3,3,3
"Region10","holding","Airline","November",11,2,2,3,3,14,336,354,17,18,350,21,371,3,3,4,5,3,2
"Region10","holding","Hardware Store","January",13,4,4,3,4,13,357,381,17,24,370,28,398,2,3,5,3,2,2
"Region10","holding","Hardware Store","February",11,3,4,4,4,15,310,332,19,22,325,26,351,4,4,5,4,4,3
"Region10","holding","Hardware Store","March",11,3,4,4,4,12,306,328,16,22,318,26,344,5,3,4,3,3,4
"Region10","holding","Hardware Store","April",12,4,2,2,2,11,387,407,13,20,398,22,420,5,4,3,5,4,2
"Region10","holding","Hardware Store","May",13,2,3,5,4,13,459,482,17,23,472,27,499,3,4,4,3,3,4
"Region10","holding","Hardware Store","June",13,4,4,4,3,11,317,342,14,25,328,28,356,2,2,2,5,5,5
"Region10","holding","Hardware Store","July",13,2,3,4,4,10,359,381,14,22,369,26,395,4,4,2,4,2,2
"Region10","holding","Hardware Store","August",13,4,3,3,2,11,310,333,13,23,321,25,346,4,4,5,2,4,4
"Region10","holding","Hardware Store","September",12,4,3,3,4,15,351,373,19,22,366,26,392,4,4,4,3,3,4
"Region10","holding","Hardware Store","October",12,5,3,4,5,12,479,503,17,24,491,29,520,2,4,5,4,3,4
"Region10","holding","Hardware Store","November",12,5,2,3,3,14,442,464,17,22,456,25,481,3,3,2,4,3,5
"Region10","holding","Computer Store","January",12,3,5,2,2,14,345,367,16,22,359,24,383,4,3,4,4,4,3
"Region10","holding","Computer Store","February",11,3,3,2,2,13,383,402,15,19,396,21,417,3,2,5,5,5,3
"Region10","holding","Computer Store","March",12,4,5,3,3,11,458,482,14,24,469,27,496,4,3,3,3,5,4
"Region10","holding","Computer Store","April",11,3,2,3,4,12,368,387,16,19,380,23,403,3,4,4,5,2,3
"Region10","holding","Computer Store","May",13,5,3,3,3,13,492,516,16,24,505,27,532,3,4,5,2,2,2
"Region10","holding","Computer Store","June",11,3,2,4,3,14,441,461,17,20,455,23,478,4,4,3,4,2,2
"Region10","holding","Computer Store","July",10,3,2,3,2,11,311,329,13,18,322,20,342,5,3,3,3,5,2
"Region10","holding","Computer Store","August",13,2,4,4,3,11,389,412,14,23,400,26,426,3,4,4,3,3,3
"Region10","holding","Computer Store","September",12,2,5,5,2,13,307,331,15,24,320,26,346,3,4,3,5,3,2
"Region10","holding","Computer Store","October",12,3,4,4,2,15,339,362,17,23,354,25,379,4,2,3,3,5,2
"Region10","holding","Computer Store","November",12,5,5,4,4,11,402,428,15,26,413,30,443,4,3,3,5,4,4
"Region10","holding","Gaming Zone","January",12,4,4,4,4,10,363,387,14,24,373,28,401,3,4,4,3,5,3
"Region10","holding","Gaming Zone","February",12,3,4,4,2,11,424,447,13,23,435,25,460,5,2,3,5,2,3
"Region10","holding","Gaming Zone","March",12,3,2,3,3,12,364,384,15,20,376,23,399,5,3,4,5,3,3
"Region10","holding","Gaming Zone","April",11,4,3,3,5,11,401,422,16,21,412,26,438,5,4,2,4,3,3
"Region10","holding","Gaming Zone","May",12,4,3,3,3,12,415,437,15,22,427,25,452,2,4,3,2,4,4
"Region10","holding","Gaming Zone","June",12,4,3,3,3,10,315,337,13,22,325,25,350,5,4,5,4,4,5
"Region10","holding","Gaming Zone","July",11,5,4,4,4,14,478,502,18,24,492,28,520,4,2,2,3,2,5
"Region10","holding","Gaming Zone","August",12,4,3,2,3,14,311,332,17,21,325,24,349,2,4,3,5,5,4
"Region10","holding","Gaming Zone","September",11,5,4,4,5,14,388,412,19,24,402,29,431,4,4,5,3,5,3
"Region10","holding","Gaming Zone","October",13,3,3,4,4,11,318,341,15,23,329,27,356,3,5,5,2,5,4
"Region10","holding","Gaming Zone","November",10,2,3,4,5,13,427,446,18,19,440,24,464,4,2,3,4,3,3
"Region10","holding","Super MArket","January",13,4,2,2,4,15,396,417,19,21,411,25,436,4,3,4,3,4,2
"Region10","holding","Super MArket","February",11,2,4,3,3,13,341,361,16,20,354,23,377,4,4,4,4,5,3
"Region10","holding","Super MArket","March",11,4,2,3,5,11,336,356,16,20,347,25,372,4,4,5,4,3,4
"Region10","holding","Super MArket","April",10,3,2,4,3,12,314,333,15,19,326,22,348,3,5,2,2,2,3
"Region10","holding","Super MArket","May",13,4,4,2,4,11,393,416,15,23,404,27,431,4,5,3,5,3,3
"Region10","holding","Super MArket","June",10,3,4,4,3,13,309,330,16,21,322,24,346,3,3,3,5,3,4
"Region10","holding","Super MArket","July",12,5,5,2,4,11,430,454,15,24,441,28,469,3,2,5,3,4,5
"Region10","holding","Super MArket","August",12,2,5,5,4,15,365,389,19,24,380,28,408,3,4,2,2,4,3
"Region10","holding","Super MArket","September",11,3,5,3,3,11,361,383,14,22,372,25,397,5,4,3,5,4,5
"Region10","holding","Super MArket","October",12,3,4,4,5,12,444,467,17,23,456,28,484,4,4,3,3,4,3
"Region10","holding","Super MArket","November",11,4,4,3,2,15,308,330,17,22,323,24,347,5,3,4,3,5,2
"Region10","holding","Fast Food Centre","January",12,3,3,4,2,11,452,474,13,22,463,24,487,3,3,2,5,2,2
"Region10","holding","Fast Food Centre","February",12,4,4,5,4,12,391,416,16,25,403,29,432,4,4,4,4,4,2
"Region10","holding","Fast Food Centre","March",10,3,4,5,2,10,352,374,12,22,362,24,386,2,5,3,2,3,3
"Region10","holding","Fast Food Centre","April",11,2,4,3,2,14,383,403,16,20,397,22,419,3,4,2,3,5,3
"Region10","holding","Fast Food Centre","May",11,5,4,3,3,10,487,510,13,23,497,26,523,5,2,2,4,5,3
"Region10","holding","Fast Food Centre","June",11,3,3,3,4,15,305,325,19,20,320,24,344,4,4,3,2,3,4
"Region10","holding","Fast Food Centre","July",13,4,3,2,4,14,363,385,18,22,377,26,403,5,3,2,5,4,3
"Region10","holding","Fast Food Centre","August",12,4,5,4,4,11,373,398,15,25,384,29,413,3,4,4,3,2,3
"Region10","holding","Fast Food Centre","September",10,5,4,4,4,14,498,521,18,23,512,27,539,3,4,2,2,3,3
"Region10","holding","Fast Food Centre","October",10,5,4,2,3,13,492,513,16,21,505,24,529,5,4,2,4,4,3
"Region10","holding","Fast Food Centre","November",13,5,4,3,3,11,429,454,14,25,440,28,468,4,4,4,3,3,3
